	Cardio	CparvumIowaII	CveliaCCMP	Neph10	Pfalciparum3D7	Tgondii	Total
OG0000000	42	16	23	602	22	25	730
OG0000001	27	5	23	558	13	15	641
OG0000002	65	6	395	23	6	6	501
OG0000003	44	17	30	262	10	16	379
OG0000004	29	6	6	283	6	9	339
OG0000005	0	2	287	0	0	0	289
OG0000006	32	0	168	24	4	9	237
OG0000007	14	2	197	2	0	0	215
OG0000008	3	1	201	0	1	2	208
OG0000009	27	3	45	112	7	10	204
OG0000010	0	0	184	0	0	1	185
OG0000011	0	0	139	0	2	2	143
OG0000012	0	0	140	0	2	0	142
OG0000013	20	0	117	0	1	0	138
OG0000014	14	2	50	66	0	5	137
OG0000015	3	1	1	125	2	2	134
OG0000016	12	1	5	107	1	3	129
OG0000017	6	2	11	101	1	3	124
OG0000018	0	0	1	0	98	0	99
OG0000019	7	4	10	74	1	2	98
OG0000020	34	3	20	18	4	18	97
OG0000021	20	1	3	61	2	2	89
OG0000022	9	1	3	69	2	3	87
OG0000023	3	0	84	0	0	0	87
OG0000024	43	1	18	5	6	13	86
OG0000025	15	1	9	56	3	1	85
OG0000026	5	2	0	74	2	2	85
OG0000027	16	0	60	6	1	1	84
OG0000028	10	1	3	63	3	3	83
OG0000029	7	1	1	72	1	1	83
OG0000030	6	2	10	59	1	4	82
OG0000031	5	1	3	70	1	1	81
OG0000032	1	0	0	80	0	0	81
OG0000033	28	1	2	47	1	1	80
OG0000034	8	3	5	59	2	2	79
OG0000035	3	2	17	54	1	2	79
OG0000036	11	0	2	61	1	2	77
OG0000037	6	0	1	67	1	1	76
OG0000038	19	3	4	45	3	2	76
OG0000039	26	1	21	12	3	13	76
OG0000040	8	1	2	63	1	1	76
OG0000041	5	1	1	63	0	1	71
OG0000042	7	1	2	41	4	16	71
OG0000043	18	1	4	45	1	2	71
OG0000044	2	1	5	60	1	1	70
OG0000045	9	2	5	52	0	2	70
OG0000046	17	2	5	39	3	3	69
OG0000047	15	0	1	51	0	1	68
OG0000048	12	2	1	47	3	3	68
OG0000049	6	1	3	56	1	1	68
OG0000050	16	3	16	25	4	4	68
OG0000051	0	0	68	0	0	0	68
OG0000052	8	0	1	56	0	0	65
OG0000053	2	1	3	56	1	1	64
OG0000054	23	4	7	22	3	4	63
OG0000055	1	0	57	0	2	3	63
OG0000056	11	3	11	31	4	3	63
OG0000057	4	5	32	11	3	7	62
OG0000058	5	2	6	40	3	4	60
OG0000059	11	1	4	36	3	4	59
OG0000060	6	1	3	47	1	1	59
OG0000061	11	1	17	24	1	4	58
OG0000062	8	0	41	4	4	1	58
OG0000063	10	4	6	29	3	6	58
OG0000064	13	1	1	40	1	1	57
OG0000065	10	1	6	29	4	6	56
OG0000066	3	0	1	50	1	1	56
OG0000067	14	1	4	34	1	2	56
OG0000068	2	0	0	54	0	0	56
OG0000069	0	0	56	0	0	0	56
OG0000070	8	2	3	37	2	3	55
OG0000071	6	1	1	45	1	1	55
OG0000072	16	1	3	31	2	2	55
OG0000073	17	0	1	36	0	1	55
OG0000074	2	1	1	50	0	1	55
OG0000075	2	1	3	46	1	1	54
OG0000076	8	1	1	42	1	1	54
OG0000077	2	1	3	46	1	1	54
OG0000078	1	0	48	3	0	1	53
OG0000079	3	1	2	46	1	0	53
OG0000080	12	2	3	32	2	2	53
OG0000081	0	0	50	1	1	1	53
OG0000082	0	0	53	0	0	0	53
OG0000083	11	2	25	12	1	1	52
OG0000084	12	0	0	40	0	0	52
OG0000085	10	1	3	36	1	1	52
OG0000086	10	1	1	38	1	1	52
OG0000087	11	1	4	34	1	1	52
OG0000088	1	1	49	1	0	0	52
OG0000089	25	1	4	18	1	2	51
OG0000090	11	0	2	34	2	2	51
OG0000091	11	1	3	32	2	2	51
OG0000092	9	2	3	32	2	2	50
OG0000093	6	1	5	36	1	1	50
OG0000094	28	0	2	18	1	1	50
OG0000095	5	0	2	42	0	1	50
OG0000096	8	1	1	40	0	0	50
OG0000097	12	0	1	36	0	1	50
OG0000098	11	0	2	33	1	2	49
OG0000099	5	1	1	39	1	1	48
OG0000100	15	3	8	18	2	2	48
OG0000101	8	3	5	25	3	4	48
OG0000102	0	0	44	3	0	1	48
OG0000103	2	0	0	41	3	1	47
OG0000104	4	0	1	40	1	1	47
OG0000105	7	1	0	17	21	1	47
OG0000106	10	1	8	25	1	2	47
OG0000107	2	1	42	0	1	1	47
OG0000108	7	0	9	27	2	1	46
OG0000109	5	1	1	37	1	1	46
OG0000110	17	1	2	22	2	2	46
OG0000111	6	0	2	36	1	1	46
OG0000112	13	5	6	12	5	5	46
OG0000113	8	1	21	13	1	2	46
OG0000114	30	0	2	12	1	1	46
OG0000115	7	1	2	33	1	1	45
OG0000116	2	1	1	39	1	1	45
OG0000117	4	1	1	37	1	1	45
OG0000118	4	1	1	37	1	1	45
OG0000119	4	2	6	28	2	3	45
OG0000120	18	1	2	20	1	3	45
OG0000121	5	1	0	38	0	1	45
OG0000122	1	0	0	43	0	1	45
OG0000123	4	1	2	35	1	1	44
OG0000124	7	5	14	8	4	6	44
OG0000125	2	1	0	39	1	1	44
OG0000126	27	1	1	13	1	1	44
OG0000127	2	0	2	37	1	1	43
OG0000128	2	0	4	34	1	2	43
OG0000129	13	0	1	25	2	2	43
OG0000130	6	1	2	32	1	1	43
OG0000131	5	1	1	34	1	1	43
OG0000132	4	1	9	27	1	1	43
OG0000133	2	1	1	37	1	1	43
OG0000134	7	2	4	23	4	3	43
OG0000135	1	0	3	39	0	0	43
OG0000136	0	1	0	40	1	1	43
OG0000137	2	0	3	37	0	0	42
OG0000138	4	3	3	27	3	2	42
OG0000139	3	0	5	32	1	1	42
OG0000140	7	4	10	15	3	3	42
OG0000141	4	1	2	33	1	1	42
OG0000142	4	1	1	34	1	1	42
OG0000143	6	1	3	29	1	2	42
OG0000144	2	1	3	20	14	2	42
OG0000145	2	1	3	34	1	0	41
OG0000146	5	2	3	27	1	3	41
OG0000147	9	1	1	28	1	1	41
OG0000148	5	0	1	34	0	1	41
OG0000149	4	1	1	33	1	1	41
OG0000150	8	2	2	25	2	2	41
OG0000151	14	0	0	25	1	1	41
OG0000152	4	1	2	32	1	1	41
OG0000153	2	0	0	38	0	1	41
OG0000154	4	0	3	31	1	1	40
OG0000155	9	3	3	21	2	2	40
OG0000156	5	1	1	31	1	1	40
OG0000157	7	1	1	29	1	1	40
OG0000158	4	1	0	33	1	1	40
OG0000159	4	3	6	21	3	3	40
OG0000160	2	0	4	30	1	3	40
OG0000161	1	1	2	36	0	0	40
OG0000162	0	0	0	40	0	0	40
OG0000163	4	1	1	31	1	1	39
OG0000164	6	1	3	26	1	2	39
OG0000165	20	0	8	10	0	1	39
OG0000166	3	0	1	34	0	1	39
OG0000167	5	1	2	29	1	1	39
OG0000168	5	1	1	29	1	2	39
OG0000169	13	2	1	21	0	2	39
OG0000170	3	1	1	32	1	1	39
OG0000171	17	0	3	14	3	2	39
OG0000172	4	0	4	31	0	0	39
OG0000173	2	0	3	32	1	1	39
OG0000174	1	1	34	0	2	1	39
OG0000175	3	0	3	31	0	1	38
OG0000176	10	2	5	16	3	2	38
OG0000177	7	0	1	28	1	1	38
OG0000178	9	0	1	26	1	1	38
OG0000179	3	1	11	20	1	2	38
OG0000180	11	1	1	23	1	1	38
OG0000181	3	0	0	34	0	1	38
OG0000182	2	2	2	30	1	1	38
OG0000183	5	0	2	27	1	2	37
OG0000184	7	1	6	21	1	1	37
OG0000185	2	1	1	30	1	2	37
OG0000186	10	1	3	18	2	3	37
OG0000187	8	1	5	22	0	1	37
OG0000188	12	1	2	20	1	1	37
OG0000189	13	1	1	20	1	1	37
OG0000190	2	0	0	29	3	3	37
OG0000191	4	1	1	29	1	1	37
OG0000192	2	2	0	31	1	1	37
OG0000193	3	1	1	30	1	1	37
OG0000194	9	2	7	14	1	3	36
OG0000195	8	2	0	23	1	2	36
OG0000196	7	5	9	8	2	5	36
OG0000197	6	1	1	26	1	1	36
OG0000198	9	1	2	22	0	2	36
OG0000199	4	1	0	28	0	3	36
OG0000200	12	2	2	18	1	1	36
OG0000201	5	1	2	27	0	1	36
OG0000202	4	13	7	6	1	5	36
OG0000203	2	2	3	25	2	2	36
OG0000204	0	0	35	0	0	1	36
OG0000205	8	1	2	22	1	1	35
OG0000206	3	1	3	26	1	1	35
OG0000207	6	0	6	21	1	1	35
OG0000208	13	0	13	8	0	1	35
OG0000209	26	0	1	6	1	1	35
OG0000210	5	2	2	22	2	2	35
OG0000211	4	0	1	28	1	1	35
OG0000212	2	2	1	24	3	3	35
OG0000213	1	1	1	30	1	1	35
OG0000214	9	0	0	25	0	0	34
OG0000215	3	1	1	27	1	1	34
OG0000216	4	0	1	27	1	1	34
OG0000217	1	0	1	31	0	1	34
OG0000218	3	0	2	28	0	1	34
OG0000219	11	1	1	18	2	1	34
OG0000220	16	1	3	12	1	1	34
OG0000221	6	1	1	24	1	1	34
OG0000222	5	3	2	20	2	2	34
OG0000223	6	1	2	23	1	1	34
OG0000224	3	1	3	25	1	1	34
OG0000225	3	0	3	27	0	1	34
OG0000226	3	0	1	28	1	1	34
OG0000227	8	2	3	18	0	2	33
OG0000228	7	3	2	19	0	2	33
OG0000229	2	1	4	24	1	1	33
OG0000230	11	0	1	19	1	1	33
OG0000231	4	0	1	27	0	1	33
OG0000232	8	2	2	19	1	1	33
OG0000233	4	0	1	26	1	1	33
OG0000234	5	1	3	22	1	1	33
OG0000235	12	0	6	12	1	2	33
OG0000236	3	2	8	18	1	1	33
OG0000237	3	1	3	25	0	1	33
OG0000238	7	1	7	13	3	2	33
OG0000239	3	1	2	25	1	1	33
OG0000240	19	2	3	6	1	2	33
OG0000241	4	1	1	25	1	1	33
OG0000242	4	2	2	22	2	1	33
OG0000243	2	0	1	28	1	1	33
OG0000244	16	0	6	6	2	2	32
OG0000245	2	0	7	19	0	4	32
OG0000246	3	1	1	25	1	1	32
OG0000247	4	2	5	18	1	2	32
OG0000248	1	0	9	20	1	1	32
OG0000249	7	2	15	5	1	2	32
OG0000250	9	1	1	15	2	4	32
OG0000251	3	1	5	18	2	3	32
OG0000252	4	1	1	24	1	1	32
OG0000253	4	1	4	21	1	1	32
OG0000254	4	0	3	24	0	1	32
OG0000255	4	0	1	27	0	0	32
OG0000256	14	0	1	15	1	1	32
OG0000257	6	0	0	25	1	0	32
OG0000258	7	1	2	20	1	1	32
OG0000259	5	1	0	25	0	1	32
OG0000260	5	2	5	14	3	2	31
OG0000261	12	2	3	9	3	2	31
OG0000262	1	0	0	30	0	0	31
OG0000263	3	1	1	24	1	1	31
OG0000264	16	1	1	11	1	1	31
OG0000265	1	1	1	27	0	1	31
OG0000266	2	1	1	25	1	1	31
OG0000267	6	0	0	24	0	1	31
OG0000268	29	0	0	2	0	0	31
OG0000269	1	1	1	26	1	1	31
OG0000270	1	0	1	27	1	1	31
OG0000271	1	1	1	26	1	1	31
OG0000272	3	1	1	24	1	1	31
OG0000273	3	1	1	23	1	1	30
OG0000274	5	1	1	21	1	1	30
OG0000275	5	1	1	21	1	1	30
OG0000276	3	0	1	24	1	1	30
OG0000277	3	0	2	23	1	1	30
OG0000278	7	1	8	10	2	2	30
OG0000279	7	0	1	20	1	1	30
OG0000280	4	1	1	22	1	1	30
OG0000281	11	1	4	12	1	1	30
OG0000282	9	1	1	17	1	1	30
OG0000283	12	1	2	14	0	1	30
OG0000284	7	0	2	17	2	2	30
OG0000285	5	1	2	20	1	1	30
OG0000286	5	0	1	22	1	1	30
OG0000287	5	0	1	23	0	1	30
OG0000288	3	0	1	24	1	1	30
OG0000289	5	0	1	22	1	1	30
OG0000290	6	1	1	20	1	1	30
OG0000291	3	0	1	24	1	1	30
OG0000292	1	2	1	23	1	2	30
OG0000293	1	1	1	25	1	1	30
OG0000294	1	1	0	26	1	1	30
OG0000295	4	0	1	25	0	0	30
OG0000296	0	0	28	0	1	1	30
OG0000297	0	0	30	0	0	0	30
OG0000298	3	1	1	22	1	1	29
OG0000299	13	0	1	12	2	1	29
OG0000300	5	1	1	21	0	1	29
OG0000301	3	1	0	23	1	1	29
OG0000302	6	0	2	20	1	0	29
OG0000303	6	1	1	19	1	1	29
OG0000304	6	1	1	19	1	1	29
OG0000305	7	1	1	18	1	1	29
OG0000306	16	1	1	9	1	1	29
OG0000307	10	1	3	13	1	1	29
OG0000308	2	1	2	21	2	1	29
OG0000309	7	1	1	18	1	1	29
OG0000310	3	1	2	21	1	1	29
OG0000311	3	1	3	20	0	2	29
OG0000312	3	3	2	18	1	2	29
OG0000313	11	2	1	13	1	1	29
OG0000314	13	0	1	14	0	1	29
OG0000315	14	1	1	11	1	1	29
OG0000316	6	1	3	16	1	2	29
OG0000317	7	1	2	16	2	1	29
OG0000318	1	0	2	26	0	0	29
OG0000319	5	1	3	18	1	1	29
OG0000320	3	2	1	19	2	2	29
OG0000321	5	0	4	18	1	1	29
OG0000322	0	0	27	0	1	1	29
OG0000323	3	0	2	20	1	2	28
OG0000324	5	0	4	16	2	1	28
OG0000325	7	1	1	17	1	1	28
OG0000326	7	2	2	12	2	3	28
OG0000327	5	0	9	8	3	3	28
OG0000328	3	1	1	21	1	1	28
OG0000329	4	1	1	20	1	1	28
OG0000330	8	0	5	12	1	2	28
OG0000331	5	1	1	18	1	2	28
OG0000332	1	1	2	21	1	2	28
OG0000333	1	0	0	27	0	0	28
OG0000334	3	0	0	23	1	1	28
OG0000335	7	1	2	14	2	2	28
OG0000336	4	0	1	21	1	1	28
OG0000337	6	1	1	18	1	1	28
OG0000338	24	1	1	0	1	1	28
OG0000339	6	1	1	18	1	1	28
OG0000340	5	1	2	18	1	1	28
OG0000341	3	1	1	21	1	1	28
OG0000342	3	1	1	21	1	1	28
OG0000343	12	1	1	12	1	1	28
OG0000344	7	2	4	11	2	2	28
OG0000345	1	1	16	8	1	1	28
OG0000346	3	1	1	21	1	1	28
OG0000347	3	0	2	21	1	1	28
OG0000348	1	0	1	24	1	1	28
OG0000349	2	0	0	22	2	2	28
OG0000350	0	1	1	25	0	1	28
OG0000351	2	0	1	22	1	1	27
OG0000352	10	1	3	10	1	2	27
OG0000353	5	1	1	18	1	1	27
OG0000354	5	1	1	18	1	1	27
OG0000355	1	1	2	21	1	1	27
OG0000356	2	1	1	21	1	1	27
OG0000357	7	1	3	13	1	2	27
OG0000358	5	0	7	9	3	3	27
OG0000359	1	1	1	21	2	1	27
OG0000360	9	1	2	13	1	1	27
OG0000361	3	1	0	20	1	2	27
OG0000362	4	1	1	19	1	1	27
OG0000363	3	1	2	19	0	2	27
OG0000364	6	2	7	10	0	2	27
OG0000365	5	0	1	19	1	1	27
OG0000366	8	1	1	15	1	1	27
OG0000367	9	1	1	14	1	1	27
OG0000368	5	1	1	18	1	1	27
OG0000369	3	1	1	20	1	1	27
OG0000370	3	0	1	22	0	1	27
OG0000371	1	1	1	22	1	1	27
OG0000372	5	1	2	17	1	1	27
OG0000373	6	0	1	18	1	1	27
OG0000374	21	0	4	2	0	0	27
OG0000375	2	1	2	20	1	1	27
OG0000376	8	1	2	14	1	1	27
OG0000377	11	1	1	12	1	1	27
OG0000378	8	0	1	16	2	0	27
OG0000379	6	1	1	16	2	1	27
OG0000380	14	0	1	11	0	1	27
OG0000381	14	1	2	8	1	1	27
OG0000382	11	1	1	12	1	1	27
OG0000383	5	1	3	13	3	2	27
OG0000384	2	1	1	21	1	1	27
OG0000385	3	0	1	21	1	1	27
OG0000386	5	2	3	13	2	2	27
OG0000387	2	1	1	19	2	2	27
OG0000388	2	0	2	21	1	1	27
OG0000389	1	0	1	23	1	1	27
OG0000390	2	0	1	24	0	0	27
OG0000391	1	1	0	22	1	2	27
OG0000392	3	1	12	2	5	4	27
OG0000393	1	0	0	24	1	1	27
OG0000394	2	3	0	22	0	0	27
OG0000395	2	1	1	21	1	1	27
OG0000396	5	2	4	12	2	2	27
OG0000397	1	0	0	23	1	2	27
OG0000398	2	0	1	21	1	1	26
OG0000399	2	0	3	19	1	1	26
OG0000400	2	0	1	21	1	1	26
OG0000401	4	0	3	15	2	2	26
OG0000402	2	1	1	20	1	1	26
OG0000403	3	1	1	19	1	1	26
OG0000404	3	2	2	16	1	2	26
OG0000405	13	0	1	10	1	1	26
OG0000406	3	1	1	19	1	1	26
OG0000407	1	0	2	23	0	0	26
OG0000408	2	1	4	16	1	2	26
OG0000409	2	1	1	20	1	1	26
OG0000410	9	0	5	11	1	0	26
OG0000411	4	1	1	19	0	1	26
OG0000412	3	2	1	19	0	1	26
OG0000413	3	2	3	14	2	2	26
OG0000414	5	1	1	18	0	1	26
OG0000415	4	0	2	20	0	0	26
OG0000416	2	1	1	20	1	1	26
OG0000417	1	1	1	21	1	1	26
OG0000418	4	1	1	18	1	1	26
OG0000419	6	1	1	15	1	2	26
OG0000420	6	0	1	17	1	1	26
OG0000421	3	1	1	19	1	1	26
OG0000422	9	1	3	12	0	1	26
OG0000423	6	2	8	7	1	2	26
OG0000424	17	0	2	5	1	1	26
OG0000425	3	1	1	20	0	1	26
OG0000426	1	0	0	24	0	1	26
OG0000427	1	1	1	20	2	1	26
OG0000428	5	1	1	17	1	1	26
OG0000429	6	0	0	18	1	1	26
OG0000430	6	1	1	16	1	1	26
OG0000431	2	1	1	20	1	1	26
OG0000432	1	1	1	21	1	1	26
OG0000433	2	1	1	20	1	1	26
OG0000434	1	1	1	21	1	1	26
OG0000435	3	0	2	19	1	1	26
OG0000436	1	0	24	0	0	1	26
OG0000437	0	0	0	26	0	0	26
OG0000438	5	1	5	12	0	2	25
OG0000439	9	1	0	13	2	0	25
OG0000440	7	1	1	14	1	1	25
OG0000441	5	1	2	15	1	1	25
OG0000442	7	1	2	13	1	1	25
OG0000443	7	0	1	15	1	1	25
OG0000444	4	1	0	18	1	1	25
OG0000445	2	1	2	18	1	1	25
OG0000446	5	1	1	16	1	1	25
OG0000447	6	0	2	15	1	1	25
OG0000448	5	0	1	18	0	1	25
OG0000449	5	1	1	16	1	1	25
OG0000450	2	0	0	21	1	1	25
OG0000451	3	1	1	18	1	1	25
OG0000452	3	0	2	18	1	1	25
OG0000453	8	0	2	15	0	0	25
OG0000454	10	2	2	7	2	2	25
OG0000455	7	1	1	14	1	1	25
OG0000456	3	1	1	18	1	1	25
OG0000457	1	1	2	18	1	2	25
OG0000458	11	1	1	10	1	1	25
OG0000459	8	0	1	14	1	1	25
OG0000460	8	0	1	14	1	1	25
OG0000461	9	1	1	12	1	1	25
OG0000462	5	1	1	16	1	1	25
OG0000463	5	0	1	18	0	1	25
OG0000464	14	2	2	4	1	2	25
OG0000465	3	3	7	11	0	1	25
OG0000466	5	1	1	16	1	1	25
OG0000467	8	1	2	12	1	1	25
OG0000468	22	0	1	0	1	1	25
OG0000469	2	1	5	16	0	1	25
OG0000470	15	1	1	6	1	1	25
OG0000471	8	0	1	14	1	1	25
OG0000472	6	1	1	15	1	1	25
OG0000473	9	1	2	11	1	1	25
OG0000474	2	1	1	18	1	2	25
OG0000475	3	1	1	19	0	1	25
OG0000476	4	2	13	3	2	1	25
OG0000477	3	1	2	17	1	1	25
OG0000478	2	1	2	18	1	1	25
OG0000479	4	3	10	2	2	4	25
OG0000480	4	1	1	17	1	1	25
OG0000481	3	1	1	18	1	1	25
OG0000482	1	0	22	2	0	0	25
OG0000483	2	2	0	19	1	1	25
OG0000484	2	1	1	19	1	1	25
OG0000485	0	2	2	19	0	2	25
OG0000486	0	1	1	21	1	1	25
OG0000487	0	0	2	0	23	0	25
OG0000488	0	0	1	22	1	1	25
OG0000489	4	1	1	16	1	1	24
OG0000490	2	1	1	18	1	1	24
OG0000491	4	1	1	16	1	1	24
OG0000492	5	1	1	15	1	1	24
OG0000493	4	1	0	15	2	2	24
OG0000494	6	1	3	12	1	1	24
OG0000495	1	1	4	14	1	3	24
OG0000496	3	1	10	8	1	1	24
OG0000497	2	0	1	19	1	1	24
OG0000498	12	1	2	9	0	0	24
OG0000499	3	1	2	16	1	1	24
OG0000500	6	1	3	10	2	2	24
OG0000501	7	0	5	10	1	1	24
OG0000502	3	0	1	18	1	1	24
OG0000503	7	1	1	13	1	1	24
OG0000504	1	0	1	21	0	1	24
OG0000505	1	1	2	18	1	1	24
OG0000506	6	1	1	14	1	1	24
OG0000507	7	1	1	12	2	1	24
OG0000508	7	1	4	6	3	3	24
OG0000509	3	0	2	17	1	1	24
OG0000510	6	1	1	15	0	1	24
OG0000511	18	1	3	2	0	0	24
OG0000512	6	1	1	14	1	1	24
OG0000513	1	0	1	20	1	1	24
OG0000514	4	2	3	11	1	3	24
OG0000515	2	0	1	19	1	1	24
OG0000516	3	6	7	6	1	1	24
OG0000517	7	1	2	12	1	1	24
OG0000518	8	1	1	12	1	1	24
OG0000519	2	0	1	19	1	1	24
OG0000520	5	1	1	15	1	1	24
OG0000521	2	1	1	19	0	1	24
OG0000522	4	0	1	17	1	1	24
OG0000523	2	1	0	20	0	1	24
OG0000524	14	0	2	6	1	1	24
OG0000525	5	1	1	15	1	1	24
OG0000526	18	1	1	2	1	1	24
OG0000527	4	1	1	16	1	1	24
OG0000528	13	0	1	8	1	1	24
OG0000529	1	0	0	23	0	0	24
OG0000530	15	0	1	6	1	1	24
OG0000531	3	1	1	17	1	1	24
OG0000532	4	2	3	12	1	2	24
OG0000533	5	1	2	13	1	2	24
OG0000534	6	1	1	14	1	1	24
OG0000535	1	1	1	20	0	1	24
OG0000536	1	1	5	12	1	4	24
OG0000537	1	2	0	19	1	1	24
OG0000538	1	1	2	17	1	2	24
OG0000539	1	0	2	19	1	1	24
OG0000540	0	1	8	0	0	15	24
OG0000541	0	3	7	7	1	6	24
OG0000542	1	0	1	19	1	1	23
OG0000543	3	0	1	18	1	0	23
OG0000544	5	1	1	12	2	2	23
OG0000545	3	1	1	16	1	1	23
OG0000546	2	3	2	13	0	3	23
OG0000547	3	0	2	14	2	2	23
OG0000548	2	0	10	11	0	0	23
OG0000549	1	1	1	18	1	1	23
OG0000550	4	2	4	10	1	2	23
OG0000551	1	1	1	18	1	1	23
OG0000552	1	0	1	19	1	1	23
OG0000553	5	1	1	14	1	1	23
OG0000554	8	1	1	11	1	1	23
OG0000555	5	1	1	14	1	1	23
OG0000556	10	0	1	8	1	3	23
OG0000557	4	1	3	11	2	2	23
OG0000558	11	0	2	10	0	0	23
OG0000559	4	0	10	6	1	2	23
OG0000560	1	0	1	21	0	0	23
OG0000561	2	0	0	19	1	1	23
OG0000562	9	1	2	7	2	2	23
OG0000563	6	1	1	13	1	1	23
OG0000564	3	1	1	16	1	1	23
OG0000565	4	1	2	14	1	1	23
OG0000566	3	0	1	17	1	1	23
OG0000567	3	1	1	17	0	1	23
OG0000568	9	1	2	11	0	0	23
OG0000569	4	1	0	16	1	1	23
OG0000570	5	1	1	14	1	1	23
OG0000571	7	1	1	12	1	1	23
OG0000572	10	1	1	9	1	1	23
OG0000573	3	1	1	15	1	2	23
OG0000574	5	0	4	13	0	1	23
OG0000575	4	1	2	14	1	1	23
OG0000576	4	1	1	15	1	1	23
OG0000577	3	1	1	16	1	1	23
OG0000578	2	0	0	21	0	0	23
OG0000579	13	1	1	7	1	0	23
OG0000580	1	0	1	19	1	1	23
OG0000581	3	1	1	15	1	2	23
OG0000582	7	0	1	14	0	1	23
OG0000583	6	1	2	12	1	1	23
OG0000584	4	0	0	19	0	0	23
OG0000585	4	0	1	17	0	1	23
OG0000586	6	1	1	13	1	1	23
OG0000587	13	0	1	8	0	1	23
OG0000588	2	0	1	19	0	1	23
OG0000589	4	1	1	15	1	1	23
OG0000590	5	1	1	14	1	1	23
OG0000591	3	1	0	17	1	1	23
OG0000592	7	2	5	4	2	3	23
OG0000593	4	0	11	2	3	3	23
OG0000594	1	2	4	13	1	2	23
OG0000595	2	2	1	16	1	1	23
OG0000596	5	1	1	14	1	1	23
OG0000597	3	1	1	16	1	1	23
OG0000598	1	0	1	19	1	1	23
OG0000599	3	1	1	16	1	1	23
OG0000600	1	0	2	18	1	1	23
OG0000601	2	0	1	19	0	1	23
OG0000602	3	1	1	16	1	1	23
OG0000603	2	1	0	18	1	1	23
OG0000604	1	1	1	18	1	1	23
OG0000605	0	0	0	21	1	1	23
OG0000606	4	0	2	15	0	1	22
OG0000607	6	1	1	11	1	2	22
OG0000608	3	0	1	16	1	1	22
OG0000609	11	1	3	4	1	2	22
OG0000610	3	1	2	14	1	1	22
OG0000611	4	1	4	8	2	3	22
OG0000612	6	1	9	4	0	2	22
OG0000613	2	1	0	17	1	1	22
OG0000614	5	0	1	14	1	1	22
OG0000615	5	1	13	0	1	2	22
OG0000616	1	1	1	17	1	1	22
OG0000617	7	1	1	10	1	2	22
OG0000618	2	2	5	10	2	1	22
OG0000619	4	0	1	12	2	3	22
OG0000620	5	1	2	12	1	1	22
OG0000621	6	1	1	12	1	1	22
OG0000622	3	1	2	14	1	1	22
OG0000623	3	1	1	15	1	1	22
OG0000624	6	1	2	12	0	1	22
OG0000625	8	0	1	13	0	0	22
OG0000626	4	1	1	14	1	1	22
OG0000627	10	1	1	8	1	1	22
OG0000628	6	3	3	9	0	1	22
OG0000629	2	1	2	15	1	1	22
OG0000630	1	1	2	16	1	1	22
OG0000631	8	1	1	10	1	1	22
OG0000632	9	2	4	1	2	4	22
OG0000633	6	1	1	12	1	1	22
OG0000634	11	0	2	8	0	1	22
OG0000635	2	0	1	17	1	1	22
OG0000636	1	1	1	17	1	1	22
OG0000637	6	0	1	14	0	1	22
OG0000638	18	0	1	3	0	0	22
OG0000639	8	2	0	11	0	1	22
OG0000640	19	0	2	0	0	1	22
OG0000641	15	1	1	2	1	2	22
OG0000642	3	0	1	16	1	1	22
OG0000643	2	1	1	16	1	1	22
OG0000644	4	1	2	10	2	3	22
OG0000645	5	1	1	13	1	1	22
OG0000646	6	1	1	12	1	1	22
OG0000647	3	2	5	10	1	1	22
OG0000648	5	2	1	13	0	1	22
OG0000649	2	1	1	16	1	1	22
OG0000650	5	1	1	11	3	1	22
OG0000651	3	1	1	14	2	1	22
OG0000652	1	1	3	15	1	1	22
OG0000653	3	1	1	15	1	1	22
OG0000654	1	0	1	19	1	0	22
OG0000655	2	1	1	16	1	1	22
OG0000656	4	1	1	15	0	1	22
OG0000657	1	1	1	17	1	1	22
OG0000658	2	0	1	18	0	1	22
OG0000659	1	0	3	16	1	1	22
OG0000660	3	0	1	18	0	0	22
OG0000661	1	1	1	16	2	1	22
OG0000662	0	1	2	16	1	2	22
OG0000663	5	1	4	9	1	1	21
OG0000664	3	1	1	12	2	2	21
OG0000665	2	1	1	15	1	1	21
OG0000666	5	1	0	14	0	1	21
OG0000667	3	1	1	14	1	1	21
OG0000668	1	1	1	17	0	1	21
OG0000669	4	0	3	10	2	2	21
OG0000670	1	1	1	16	1	1	21
OG0000671	2	0	2	16	0	1	21
OG0000672	5	1	1	12	1	1	21
OG0000673	4	1	2	12	1	1	21
OG0000674	3	0	3	13	1	1	21
OG0000675	4	1	1	13	1	1	21
OG0000676	2	0	1	16	1	1	21
OG0000677	9	0	1	9	1	1	21
OG0000678	18	1	1	0	0	1	21
OG0000679	4	0	0	16	0	1	21
OG0000680	3	2	6	6	1	3	21
OG0000681	7	1	3	6	1	3	21
OG0000682	2	1	1	15	1	1	21
OG0000683	3	1	1	14	1	1	21
OG0000684	3	1	13	2	1	1	21
OG0000685	3	0	1	16	0	1	21
OG0000686	6	2	2	9	1	1	21
OG0000687	3	0	1	15	1	1	21
OG0000688	9	0	1	11	0	0	21
OG0000689	5	3	3	6	2	2	21
OG0000690	2	1	1	15	1	1	21
OG0000691	3	1	0	15	1	1	21
OG0000692	9	1	1	8	1	1	21
OG0000693	16	0	1	2	1	1	21
OG0000694	6	1	1	11	1	1	21
OG0000695	4	1	6	6	2	2	21
OG0000696	5	1	2	11	1	1	21
OG0000697	3	0	2	15	0	1	21
OG0000698	15	1	3	0	1	1	21
OG0000699	2	0	1	14	2	2	21
OG0000700	1	1	4	13	1	1	21
OG0000701	3	1	1	14	1	1	21
OG0000702	3	0	0	16	0	2	21
OG0000703	13	1	1	4	1	1	21
OG0000704	12	1	0	6	1	1	21
OG0000705	9	1	1	8	1	1	21
OG0000706	1	1	2	15	1	1	21
OG0000707	13	1	1	4	1	1	21
OG0000708	2	1	1	15	1	1	21
OG0000709	3	1	1	14	0	2	21
OG0000710	3	0	3	15	0	0	21
OG0000711	3	1	1	14	1	1	21
OG0000712	2	0	0	17	1	1	21
OG0000713	7	0	2	10	1	1	21
OG0000714	1	1	1	16	1	1	21
OG0000715	1	1	1	16	1	1	21
OG0000716	2	1	1	15	1	1	21
OG0000717	3	1	1	14	1	1	21
OG0000718	3	1	1	14	1	1	21
OG0000719	1	1	1	16	1	1	21
OG0000720	2	1	1	14	2	1	21
OG0000721	2	1	1	15	1	1	21
OG0000722	1	0	0	18	1	1	21
OG0000723	1	1	1	16	1	1	21
OG0000724	2	1	1	13	1	3	21
OG0000725	1	0	0	20	0	0	21
OG0000726	1	0	2	17	0	1	21
OG0000727	1	1	1	15	2	1	21
OG0000728	0	1	3	15	1	1	21
OG0000729	0	1	1	14	2	3	21
OG0000730	7	2	4	4	2	1	20
OG0000731	7	0	1	11	0	1	20
OG0000732	3	1	3	11	1	1	20
OG0000733	5	1	1	11	1	1	20
OG0000734	1	0	3	15	0	1	20
OG0000735	3	1	1	13	1	1	20
OG0000736	5	1	1	11	1	1	20
OG0000737	4	1	1	12	1	1	20
OG0000738	15	1	0	2	1	1	20
OG0000739	2	0	1	15	1	1	20
OG0000740	3	1	0	15	0	1	20
OG0000741	1	0	0	17	1	1	20
OG0000742	2	1	2	13	1	1	20
OG0000743	2	1	1	14	1	1	20
OG0000744	2	1	0	15	1	1	20
OG0000745	2	1	2	13	1	1	20
OG0000746	9	0	1	7	1	2	20
OG0000747	4	1	1	12	1	1	20
OG0000748	6	1	1	10	1	1	20
OG0000749	3	1	1	13	1	1	20
OG0000750	12	0	1	6	0	1	20
OG0000751	2	1	4	8	2	3	20
OG0000752	9	1	1	8	0	1	20
OG0000753	4	1	3	10	1	1	20
OG0000754	5	0	2	12	1	0	20
OG0000755	5	0	2	11	1	1	20
OG0000756	2	1	3	12	1	1	20
OG0000757	3	1	1	13	1	1	20
OG0000758	3	0	0	17	0	0	20
OG0000759	6	1	2	9	1	1	20
OG0000760	8	1	1	8	1	1	20
OG0000761	1	1	1	14	1	2	20
OG0000762	3	1	11	2	1	2	20
OG0000763	3	1	1	13	1	1	20
OG0000764	4	2	0	14	0	0	20
OG0000765	6	1	1	9	2	1	20
OG0000766	5	1	1	11	1	1	20
OG0000767	7	1	1	9	1	1	20
OG0000768	1	2	1	14	1	1	20
OG0000769	4	1	2	11	1	1	20
OG0000770	3	0	1	14	1	1	20
OG0000771	2	0	4	13	0	1	20
OG0000772	4	0	3	8	3	2	20
OG0000773	5	1	1	11	1	1	20
OG0000774	6	0	2	10	1	1	20
OG0000775	10	1	1	6	1	1	20
OG0000776	5	0	1	12	1	1	20
OG0000777	3	1	0	14	1	1	20
OG0000778	1	0	0	19	0	0	20
OG0000779	17	0	0	3	0	0	20
OG0000780	1	0	0	19	0	0	20
OG0000781	4	0	2	0	7	7	20
OG0000782	4	1	1	12	1	1	20
OG0000783	1	3	8	8	0	0	20
OG0000784	1	1	3	14	0	1	20
OG0000785	2	1	5	10	1	1	20
OG0000786	3	1	2	12	1	1	20
OG0000787	3	1	0	15	0	1	20
OG0000788	2	1	1	14	1	1	20
OG0000789	2	1	1	14	1	1	20
OG0000790	4	1	1	12	1	1	20
OG0000791	2	1	1	14	1	1	20
OG0000792	2	1	1	14	1	1	20
OG0000793	2	0	1	15	1	1	20
OG0000794	5	1	2	10	1	1	20
OG0000795	2	1	1	14	1	1	20
OG0000796	2	0	1	15	1	1	20
OG0000797	2	0	1	15	1	1	20
OG0000798	2	1	1	14	1	1	20
OG0000799	1	0	3	15	0	1	20
OG0000800	2	1	1	14	1	1	20
OG0000801	0	1	17	0	1	1	20
OG0000802	0	1	1	16	1	1	20
OG0000803	2	1	1	13	1	1	19
OG0000804	4	1	1	11	1	1	19
OG0000805	6	2	4	5	1	1	19
OG0000806	4	1	2	11	0	1	19
OG0000807	5	1	1	10	1	1	19
OG0000808	5	1	1	10	1	1	19
OG0000809	5	2	1	10	0	1	19
OG0000810	3	1	1	12	1	1	19
OG0000811	2	0	0	15	1	1	19
OG0000812	6	1	1	9	1	1	19
OG0000813	4	2	1	10	1	1	19
OG0000814	2	0	1	14	1	1	19
OG0000815	4	1	2	10	1	1	19
OG0000816	3	1	2	11	1	1	19
OG0000817	4	1	2	10	1	1	19
OG0000818	4	1	1	11	1	1	19
OG0000819	8	1	1	7	1	1	19
OG0000820	6	1	2	8	1	1	19
OG0000821	5	0	2	10	1	1	19
OG0000822	3	1	1	12	1	1	19
OG0000823	12	0	1	4	1	1	19
OG0000824	3	1	1	12	1	1	19
OG0000825	3	0	1	13	1	1	19
OG0000826	3	0	0	15	0	1	19
OG0000827	9	1	1	6	1	1	19
OG0000828	2	0	0	17	0	0	19
OG0000829	6	2	2	6	1	2	19
OG0000830	4	1	7	6	0	1	19
OG0000831	3	0	0	14	1	1	19
OG0000832	3	0	1	13	1	1	19
OG0000833	3	2	4	7	1	2	19
OG0000834	4	1	1	11	1	1	19
OG0000835	5	0	2	10	1	1	19
OG0000836	4	1	2	10	1	1	19
OG0000837	4	1	1	12	0	1	19
OG0000838	4	1	1	11	1	1	19
OG0000839	1	1	1	11	3	2	19
OG0000840	3	1	3	10	1	1	19
OG0000841	7	1	1	8	1	1	19
OG0000842	6	0	2	10	0	1	19
OG0000843	2	1	3	11	1	1	19
OG0000844	2	0	2	13	1	1	19
OG0000845	9	1	3	4	1	1	19
OG0000846	6	1	2	8	1	1	19
OG0000847	11	0	0	5	2	1	19
OG0000848	8	0	1	9	0	1	19
OG0000849	2	1	0	13	1	2	19
OG0000850	6	2	2	6	1	2	19
OG0000851	2	1	2	13	0	1	19
OG0000852	7	0	2	9	0	1	19
OG0000853	4	1	1	11	1	1	19
OG0000854	3	1	1	12	1	1	19
OG0000855	12	1	2	2	1	1	19
OG0000856	4	1	1	11	1	1	19
OG0000857	10	0	1	6	1	1	19
OG0000858	2	0	0	17	0	0	19
OG0000859	5	1	1	10	1	1	19
OG0000860	4	1	3	6	2	3	19
OG0000861	3	1	2	10	2	1	19
OG0000862	4	1	0	12	0	2	19
OG0000863	4	1	1	11	1	1	19
OG0000864	2	1	1	12	2	1	19
OG0000865	3	1	1	12	1	1	19
OG0000866	1	1	1	14	1	1	19
OG0000867	3	1	1	12	1	1	19
OG0000868	1	0	1	17	0	0	19
OG0000869	1	0	1	14	1	2	19
OG0000870	3	1	1	12	1	1	19
OG0000871	4	0	0	13	0	2	19
OG0000872	2	1	1	13	1	1	19
OG0000873	1	1	1	14	1	1	19
OG0000874	3	1	1	12	1	1	19
OG0000875	5	1	1	10	1	1	19
OG0000876	5	1	1	10	1	1	19
OG0000877	3	0	1	13	1	1	19
OG0000878	3	1	1	12	1	1	19
OG0000879	2	1	2	12	1	1	19
OG0000880	1	1	15	0	1	1	19
OG0000881	4	1	1	11	1	1	19
OG0000882	5	1	1	9	2	1	19
OG0000883	7	1	1	8	1	1	19
OG0000884	1	0	1	14	1	2	19
OG0000885	4	1	1	11	1	1	19
OG0000886	5	1	1	9	1	2	19
OG0000887	3	0	3	12	0	1	19
OG0000888	4	0	1	12	1	1	19
OG0000889	1	1	17	0	0	0	19
OG0000890	2	1	1	13	1	1	19
OG0000891	2	1	12	2	1	1	19
OG0000892	4	0	1	12	1	1	19
OG0000893	3	1	1	12	1	1	19
OG0000894	1	0	2	15	0	1	19
OG0000895	2	1	2	12	1	1	19
OG0000896	0	0	19	0	0	0	19
OG0000897	0	0	19	0	0	0	19
OG0000898	0	0	1	17	0	1	19
OG0000899	4	1	1	10	1	1	18
OG0000900	6	1	1	8	1	1	18
OG0000901	4	0	5	7	1	1	18
OG0000902	5	1	1	9	1	1	18
OG0000903	2	1	1	12	1	1	18
OG0000904	3	1	1	11	1	1	18
OG0000905	6	1	1	8	1	1	18
OG0000906	2	1	5	8	1	1	18
OG0000907	3	1	0	11	1	2	18
OG0000908	3	0	0	15	0	0	18
OG0000909	7	0	0	7	3	1	18
OG0000910	3	0	1	12	1	1	18
OG0000911	9	1	2	4	1	1	18
OG0000912	4	1	1	10	1	1	18
OG0000913	4	2	6	2	2	2	18
OG0000914	4	1	3	8	1	1	18
OG0000915	6	2	2	2	2	4	18
OG0000916	2	1	1	12	1	1	18
OG0000917	4	1	1	10	1	1	18
OG0000918	4	0	1	12	0	1	18
OG0000919	3	1	1	11	1	1	18
OG0000920	4	0	0	12	1	1	18
OG0000921	2	0	1	14	0	1	18
OG0000922	3	1	1	11	1	1	18
OG0000923	2	0	1	13	1	1	18
OG0000924	2	1	4	9	1	1	18
OG0000925	1	1	1	13	1	1	18
OG0000926	2	1	3	9	1	2	18
OG0000927	2	0	1	13	1	1	18
OG0000928	2	1	1	12	1	1	18
OG0000929	4	0	1	11	1	1	18
OG0000930	2	0	1	14	0	1	18
OG0000931	3	0	3	10	1	1	18
OG0000932	10	0	7	0	0	1	18
OG0000933	4	1	2	7	1	3	18
OG0000934	1	1	0	14	1	1	18
OG0000935	9	1	1	5	1	1	18
OG0000936	2	1	1	12	1	1	18
OG0000937	1	0	2	14	0	1	18
OG0000938	4	0	1	11	1	1	18
OG0000939	6	1	1	8	1	1	18
OG0000940	2	0	3	10	1	2	18
OG0000941	1	1	3	11	1	1	18
OG0000942	2	1	1	12	1	1	18
OG0000943	2	1	2	10	1	2	18
OG0000944	17	0	1	0	0	0	18
OG0000945	3	1	1	11	1	1	18
OG0000946	6	0	1	9	1	1	18
OG0000947	3	0	1	12	1	1	18
OG0000948	3	1	0	14	0	0	18
OG0000949	2	1	1	12	1	1	18
OG0000950	8	1	1	6	1	1	18
OG0000951	5	0	2	5	4	2	18
OG0000952	5	0	4	8	1	0	18
OG0000953	3	1	1	11	1	1	18
OG0000954	2	1	1	12	1	1	18
OG0000955	6	0	0	12	0	0	18
OG0000956	4	1	4	0	6	3	18
OG0000957	8	1	1	6	1	1	18
OG0000958	4	0	1	12	0	1	18
OG0000959	3	1	2	10	1	1	18
OG0000960	6	1	2	6	2	1	18
OG0000961	4	0	0	12	1	1	18
OG0000962	5	0	0	13	0	0	18
OG0000963	6	1	1	8	1	1	18
OG0000964	4	1	4	6	1	2	18
OG0000965	7	1	3	3	1	3	18
OG0000966	8	1	1	6	1	1	18
OG0000967	5	1	1	9	1	1	18
OG0000968	4	1	2	9	1	1	18
OG0000969	6	1	1	8	1	1	18
OG0000970	3	1	2	10	1	1	18
OG0000971	5	1	1	9	1	1	18
OG0000972	3	2	6	4	1	2	18
OG0000973	5	1	2	8	1	1	18
OG0000974	7	1	1	7	1	1	18
OG0000975	4	1	0	10	2	1	18
OG0000976	10	1	2	2	2	1	18
OG0000977	3	2	0	12	0	1	18
OG0000978	1	1	5	9	1	1	18
OG0000979	3	1	1	11	1	1	18
OG0000980	5	2	5	4	1	1	18
OG0000981	1	1	1	13	1	1	18
OG0000982	2	0	0	16	0	0	18
OG0000983	4	1	3	6	2	2	18
OG0000984	1	0	0	16	0	1	18
OG0000985	3	1	1	11	1	1	18
OG0000986	2	1	1	12	1	1	18
OG0000987	1	0	0	17	0	0	18
OG0000988	2	0	2	10	2	2	18
OG0000989	2	1	1	12	1	1	18
OG0000990	4	1	1	10	1	1	18
OG0000991	1	1	1	13	1	1	18
OG0000992	2	0	1	15	0	0	18
OG0000993	1	1	1	13	1	1	18
OG0000994	1	1	1	13	1	1	18
OG0000995	1	1	1	12	1	2	18
OG0000996	1	1	3	12	0	1	18
OG0000997	2	1	2	11	1	1	18
OG0000998	3	0	2	12	0	1	18
OG0000999	3	1	1	11	1	1	18
OG0001000	2	1	1	12	1	1	18
OG0001001	3	1	1	11	1	1	18
OG0001002	2	1	3	11	0	1	18
OG0001003	2	1	2	11	1	1	18
OG0001004	3	2	1	10	1	1	18
OG0001005	4	0	1	11	1	1	18
OG0001006	1	0	2	14	0	1	18
OG0001007	3	0	0	14	0	1	18
OG0001008	3	0	0	15	0	0	18
OG0001009	2	1	4	10	0	1	18
OG0001010	1	0	17	0	0	0	18
OG0001011	2	0	1	13	1	1	18
OG0001012	1	1	5	9	1	1	18
OG0001013	4	1	1	10	1	1	18
OG0001014	4	0	1	11	1	1	18
OG0001015	1	0	1	15	0	1	18
OG0001016	0	0	18	0	0	0	18
OG0001017	0	0	2	15	0	1	18
OG0001018	0	0	0	18	0	0	18
OG0001019	8	0	2	6	0	1	17
OG0001020	2	1	1	11	1	1	17
OG0001021	5	1	1	8	1	1	17
OG0001022	4	1	1	9	1	1	17
OG0001023	5	1	0	10	0	1	17
OG0001024	2	1	2	10	1	1	17
OG0001025	6	1	1	6	1	2	17
OG0001026	3	1	1	10	1	1	17
OG0001027	2	1	2	11	0	1	17
OG0001028	8	1	2	4	1	1	17
OG0001029	1	1	1	12	1	1	17
OG0001030	2	1	1	12	0	1	17
OG0001031	1	1	0	14	0	1	17
OG0001032	5	1	1	8	1	1	17
OG0001033	2	0	1	13	0	1	17
OG0001034	3	0	1	11	1	1	17
OG0001035	3	0	1	10	1	2	17
OG0001036	2	0	0	14	1	0	17
OG0001037	5	1	1	8	1	1	17
OG0001038	1	1	1	13	1	0	17
OG0001039	5	1	1	8	1	1	17
OG0001040	9	0	1	6	0	1	17
OG0001041	8	0	1	6	1	1	17
OG0001042	3	1	1	10	1	1	17
OG0001043	6	0	0	10	0	1	17
OG0001044	3	1	1	10	1	1	17
OG0001045	2	1	1	11	1	1	17
OG0001046	3	1	1	10	1	1	17
OG0001047	2	1	1	11	1	1	17
OG0001048	3	0	1	13	0	0	17
OG0001049	4	1	1	10	1	0	17
OG0001050	6	0	1	6	2	2	17
OG0001051	4	0	0	11	1	1	17
OG0001052	2	0	1	12	1	1	17
OG0001053	4	1	1	9	1	1	17
OG0001054	7	1	1	6	1	1	17
OG0001055	4	0	1	12	0	0	17
OG0001056	4	0	1	10	1	1	17
OG0001057	4	1	1	10	0	1	17
OG0001058	1	1	1	12	1	1	17
OG0001059	8	0	1	8	0	0	17
OG0001060	4	1	1	9	1	1	17
OG0001061	6	0	3	6	1	1	17
OG0001062	2	1	0	12	1	1	17
OG0001063	2	1	2	10	0	2	17
OG0001064	5	1	1	8	1	1	17
OG0001065	2	1	2	10	1	1	17
OG0001066	8	0	1	6	1	1	17
OG0001067	2	0	1	12	1	1	17
OG0001068	12	0	2	2	0	1	17
OG0001069	2	1	1	11	1	1	17
OG0001070	9	1	1	4	1	1	17
OG0001071	10	0	0	5	1	1	17
OG0001072	7	0	3	4	1	2	17
OG0001073	4	1	1	9	1	1	17
OG0001074	2	1	0	12	1	1	17
OG0001075	5	1	1	8	1	1	17
OG0001076	5	0	1	9	1	1	17
OG0001077	9	0	0	6	1	1	17
OG0001078	3	1	1	10	1	1	17
OG0001079	2	0	0	15	0	0	17
OG0001080	6	1	1	7	1	1	17
OG0001081	6	1	1	7	1	1	17
OG0001082	3	1	2	7	3	1	17
OG0001083	11	0	1	4	0	1	17
OG0001084	3	1	1	10	1	1	17
OG0001085	5	0	1	9	1	1	17
OG0001086	3	1	2	8	2	1	17
OG0001087	8	0	0	9	0	0	17
OG0001088	8	1	1	5	1	1	17
OG0001089	3	1	1	10	1	1	17
OG0001090	2	0	1	14	0	0	17
OG0001091	6	0	0	11	0	0	17
OG0001092	4	1	0	11	0	1	17
OG0001093	5	1	1	8	1	1	17
OG0001094	3	1	2	10	0	1	17
OG0001095	2	1	2	10	1	1	17
OG0001096	3	1	1	10	1	1	17
OG0001097	1	1	1	12	1	1	17
OG0001098	1	1	1	13	1	0	17
OG0001099	2	0	1	12	1	1	17
OG0001100	2	1	2	10	1	1	17
OG0001101	1	0	0	12	1	3	17
OG0001102	4	1	3	6	0	3	17
OG0001103	4	1	1	9	1	1	17
OG0001104	2	1	1	11	1	1	17
OG0001105	2	1	4	9	0	1	17
OG0001106	3	1	2	9	1	1	17
OG0001107	3	1	1	10	1	1	17
OG0001108	1	1	1	12	1	1	17
OG0001109	1	1	1	12	1	1	17
OG0001110	4	1	1	10	0	1	17
OG0001111	2	0	4	10	1	0	17
OG0001112	3	1	1	10	1	1	17
OG0001113	3	0	6	5	0	3	17
OG0001114	2	1	1	11	1	1	17
OG0001115	1	1	1	12	1	1	17
OG0001116	1	0	0	14	1	1	17
OG0001117	1	1	1	12	1	1	17
OG0001118	2	0	1	12	1	1	17
OG0001119	4	1	1	9	1	1	17
OG0001120	1	0	5	9	0	2	17
OG0001121	2	0	0	13	1	1	17
OG0001122	1	1	1	12	1	1	17
OG0001123	2	1	1	12	0	1	17
OG0001124	2	0	3	10	1	1	17
OG0001125	2	0	1	10	2	2	17
OG0001126	1	1	1	12	1	1	17
OG0001127	2	1	1	11	1	1	17
OG0001128	3	0	0	12	1	1	17
OG0001129	1	1	1	12	1	1	17
OG0001130	1	1	1	12	1	1	17
OG0001131	3	1	1	10	1	1	17
OG0001132	2	1	2	10	1	1	17
OG0001133	1	1	2	11	1	1	17
OG0001134	4	0	1	11	0	1	17
OG0001135	1	1	0	14	0	1	17
OG0001136	3	1	1	10	1	1	17
OG0001137	2	1	1	11	1	1	17
OG0001138	2	1	7	5	0	2	17
OG0001139	1	1	1	12	1	1	17
OG0001140	3	0	1	11	1	1	17
OG0001141	1	1	1	12	1	1	17
OG0001142	0	1	1	12	2	1	17
OG0001143	0	1	1	14	0	1	17
OG0001144	0	0	3	14	0	0	17
OG0001145	0	0	2	11	2	2	17
OG0001146	0	0	3	14	0	0	17
OG0001147	0	0	1	14	1	1	17
OG0001148	0	0	0	14	1	2	17
OG0001149	3	1	1	8	1	2	16
OG0001150	2	1	1	9	2	1	16
OG0001151	1	1	1	12	0	1	16
OG0001152	3	0	1	12	0	0	16
OG0001153	3	1	1	9	1	1	16
OG0001154	3	1	4	4	2	2	16
OG0001155	4	1	1	8	1	1	16
OG0001156	3	1	4	4	1	3	16
OG0001157	5	1	1	5	2	2	16
OG0001158	2	0	0	13	0	1	16
OG0001159	2	1	1	10	1	1	16
OG0001160	6	1	1	6	1	1	16
OG0001161	2	1	1	10	1	1	16
OG0001162	3	0	0	12	0	1	16
OG0001163	2	0	1	12	0	1	16
OG0001164	4	1	1	8	1	1	16
OG0001165	2	0	1	11	1	1	16
OG0001166	3	0	1	10	1	1	16
OG0001167	1	0	0	15	0	0	16
OG0001168	3	0	1	10	1	1	16
OG0001169	3	1	2	6	3	1	16
OG0001170	4	1	1	8	1	1	16
OG0001171	7	0	1	6	1	1	16
OG0001172	3	0	1	10	1	1	16
OG0001173	5	1	2	6	1	1	16
OG0001174	4	1	1	8	1	1	16
OG0001175	2	0	1	12	0	1	16
OG0001176	1	1	1	12	0	1	16
OG0001177	2	0	1	12	0	1	16
OG0001178	4	1	3	2	3	3	16
OG0001179	4	1	1	8	1	1	16
OG0001180	2	1	2	9	1	1	16
OG0001181	1	0	1	12	1	1	16
OG0001182	3	0	1	10	1	1	16
OG0001183	2	1	1	10	1	1	16
OG0001184	1	0	1	14	0	0	16
OG0001185	3	0	2	9	1	1	16
OG0001186	3	1	1	9	1	1	16
OG0001187	3	1	1	9	1	1	16
OG0001188	4	1	1	8	1	1	16
OG0001189	2	0	1	11	1	1	16
OG0001190	6	1	1	6	1	1	16
OG0001191	4	1	1	8	1	1	16
OG0001192	1	0	1	14	0	0	16
OG0001193	4	0	0	10	1	1	16
OG0001194	6	1	1	6	1	1	16
OG0001195	5	0	0	10	1	0	16
OG0001196	4	1	1	8	1	1	16
OG0001197	1	0	1	12	1	1	16
OG0001198	4	1	1	8	1	1	16
OG0001199	4	1	1	8	1	1	16
OG0001200	2	1	1	10	1	1	16
OG0001201	13	0	0	3	0	0	16
OG0001202	8	1	1	4	1	1	16
OG0001203	7	2	2	4	0	1	16
OG0001204	6	1	1	6	1	1	16
OG0001205	3	1	2	8	1	1	16
OG0001206	8	0	0	7	1	0	16
OG0001207	6	1	1	6	1	1	16
OG0001208	1	1	1	11	1	1	16
OG0001209	3	1	1	8	1	2	16
OG0001210	4	1	2	3	5	1	16
OG0001211	8	1	1	4	1	1	16
OG0001212	6	1	1	6	1	1	16
OG0001213	10	1	1	2	1	1	16
OG0001214	2	1	2	9	1	1	16
OG0001215	8	0	0	8	0	0	16
OG0001216	10	0	1	4	0	1	16
OG0001217	7	1	0	7	0	1	16
OG0001218	8	1	1	4	1	1	16
OG0001219	8	1	3	2	1	1	16
OG0001220	7	0	0	8	1	0	16
OG0001221	4	0	0	11	0	1	16
OG0001222	4	0	1	9	1	1	16
OG0001223	6	1	1	6	1	1	16
OG0001224	4	0	2	9	0	1	16
OG0001225	3	1	1	10	0	1	16
OG0001226	6	0	1	8	0	1	16
OG0001227	1	1	2	10	1	1	16
OG0001228	8	0	1	6	1	0	16
OG0001229	2	1	1	10	1	1	16
OG0001230	2	0	2	10	1	1	16
OG0001231	6	0	0	9	0	1	16
OG0001232	1	1	0	13	1	0	16
OG0001233	11	1	0	2	1	1	16
OG0001234	12	0	2	2	0	0	16
OG0001235	2	1	2	8	1	2	16
OG0001236	2	1	1	10	1	1	16
OG0001237	2	1	1	10	1	1	16
OG0001238	1	0	1	12	1	1	16
OG0001239	1	0	1	14	0	0	16
OG0001240	3	1	0	10	1	1	16
OG0001241	1	1	1	13	0	0	16
OG0001242	7	0	1	6	1	1	16
OG0001243	3	1	2	9	0	1	16
OG0001244	4	1	1	8	1	1	16
OG0001245	5	1	1	7	1	1	16
OG0001246	2	0	0	14	0	0	16
OG0001247	2	0	1	10	1	2	16
OG0001248	2	2	2	6	2	2	16
OG0001249	4	1	1	8	1	1	16
OG0001250	1	1	0	12	1	1	16
OG0001251	1	1	1	11	1	1	16
OG0001252	1	0	1	12	1	1	16
OG0001253	1	0	2	12	0	1	16
OG0001254	3	0	1	10	1	1	16
OG0001255	1	0	2	11	1	1	16
OG0001256	1	1	1	11	1	1	16
OG0001257	1	0	1	12	1	1	16
OG0001258	1	0	1	12	1	1	16
OG0001259	1	0	1	12	1	1	16
OG0001260	2	1	1	10	1	1	16
OG0001261	1	1	1	11	1	1	16
OG0001262	2	0	0	12	1	1	16
OG0001263	1	0	1	12	1	1	16
OG0001264	3	0	0	8	4	1	16
OG0001265	3	0	1	10	1	1	16
OG0001266	3	1	1	10	0	1	16
OG0001267	3	1	1	9	1	1	16
OG0001268	3	0	1	10	1	1	16
OG0001269	1	0	1	11	1	2	16
OG0001270	2	1	2	10	0	1	16
OG0001271	1	0	1	14	0	0	16
OG0001272	2	1	1	10	1	1	16
OG0001273	2	0	3	10	0	1	16
OG0001274	1	2	0	10	1	2	16
OG0001275	1	0	2	11	1	1	16
OG0001276	2	1	1	10	1	1	16
OG0001277	1	1	1	12	0	1	16
OG0001278	5	1	2	6	1	1	16
OG0001279	3	0	2	9	0	2	16
OG0001280	0	1	2	9	2	2	16
OG0001281	0	1	3	10	1	1	16
OG0001282	0	1	1	12	1	1	16
OG0001283	0	0	13	0	1	2	16
OG0001284	0	0	1	13	1	1	16
OG0001285	0	0	1	14	0	1	16
OG0001286	0	0	0	15	0	1	16
OG0001287	1	1	2	9	1	1	15
OG0001288	1	1	2	9	1	1	15
OG0001289	1	1	2	8	2	1	15
OG0001290	6	1	1	5	1	1	15
OG0001291	4	0	1	8	1	1	15
OG0001292	5	0	1	7	1	1	15
OG0001293	3	0	1	8	2	1	15
OG0001294	2	1	2	8	1	1	15
OG0001295	5	1	1	6	1	1	15
OG0001296	3	0	12	0	0	0	15
OG0001297	9	0	2	2	1	1	15
OG0001298	2	1	2	8	1	1	15
OG0001299	2	2	2	6	1	2	15
OG0001300	6	1	1	6	0	1	15
OG0001301	3	0	1	10	0	1	15
OG0001302	5	0	1	8	0	1	15
OG0001303	3	1	4	4	1	2	15
OG0001304	4	1	0	8	1	1	15
OG0001305	2	1	3	6	1	2	15
OG0001306	4	0	1	8	1	1	15
OG0001307	2	0	1	10	1	1	15
OG0001308	3	1	1	8	1	1	15
OG0001309	7	0	0	6	0	2	15
OG0001310	1	0	1	12	0	1	15
OG0001311	5	1	1	6	1	1	15
OG0001312	7	1	3	2	1	1	15
OG0001313	6	1	1	5	1	1	15
OG0001314	7	1	1	4	1	1	15
OG0001315	4	1	1	7	1	1	15
OG0001316	1	0	1	10	1	2	15
OG0001317	7	1	0	5	1	1	15
OG0001318	3	1	1	8	1	1	15
OG0001319	2	1	1	9	1	1	15
OG0001320	7	1	1	4	1	1	15
OG0001321	1	0	0	14	0	0	15
OG0001322	3	1	1	8	1	1	15
OG0001323	3	1	1	8	1	1	15
OG0001324	4	5	3	2	1	0	15
OG0001325	1	0	1	12	0	1	15
OG0001326	2	1	3	7	1	1	15
OG0001327	3	1	1	9	0	1	15
OG0001328	4	0	0	10	0	1	15
OG0001329	10	0	2	2	0	1	15
OG0001330	5	0	1	7	1	1	15
OG0001331	6	0	1	6	1	1	15
OG0001332	2	0	2	8	1	2	15
OG0001333	5	1	1	7	0	1	15
OG0001334	6	1	1	5	1	1	15
OG0001335	3	1	1	8	1	1	15
OG0001336	3	1	1	8	1	1	15
OG0001337	3	1	1	8	1	1	15
OG0001338	1	0	2	11	0	1	15
OG0001339	13	0	0	2	0	0	15
OG0001340	3	1	1	8	1	1	15
OG0001341	6	0	2	5	1	1	15
OG0001342	4	0	1	8	1	1	15
OG0001343	3	1	1	8	1	1	15
OG0001344	3	1	1	8	1	1	15
OG0001345	4	0	1	8	1	1	15
OG0001346	1	0	1	12	0	1	15
OG0001347	4	1	2	6	1	1	15
OG0001348	2	2	1	6	2	2	15
OG0001349	1	1	1	10	1	1	15
OG0001350	2	1	1	9	1	1	15
OG0001351	4	1	1	8	0	1	15
OG0001352	6	0	1	7	0	1	15
OG0001353	5	0	2	6	1	1	15
OG0001354	6	1	4	2	1	1	15
OG0001355	3	1	1	8	1	1	15
OG0001356	1	1	1	10	1	1	15
OG0001357	5	1	1	6	1	1	15
OG0001358	3	1	3	6	1	1	15
OG0001359	2	1	1	9	1	1	15
OG0001360	2	1	2	8	1	1	15
OG0001361	4	1	1	7	1	1	15
OG0001362	4	1	1	7	1	1	15
OG0001363	5	1	3	4	1	1	15
OG0001364	5	1	1	6	1	1	15
OG0001365	8	0	0	6	1	0	15
OG0001366	6	1	1	7	0	0	15
OG0001367	1	1	1	10	1	1	15
OG0001368	5	1	1	6	1	1	15
OG0001369	4	1	2	6	1	1	15
OG0001370	8	0	1	4	1	1	15
OG0001371	4	1	1	7	1	1	15
OG0001372	4	1	0	8	1	1	15
OG0001373	5	0	0	10	0	0	15
OG0001374	1	1	1	9	2	1	15
OG0001375	1	0	14	0	0	0	15
OG0001376	1	1	1	10	1	1	15
OG0001377	1	2	2	6	1	3	15
OG0001378	2	1	4	6	1	1	15
OG0001379	2	0	1	10	1	1	15
OG0001380	1	1	1	10	1	1	15
OG0001381	1	1	1	10	1	1	15
OG0001382	3	0	1	9	1	1	15
OG0001383	3	0	0	9	1	2	15
OG0001384	2	1	3	7	1	1	15
OG0001385	3	1	2	7	1	1	15
OG0001386	1	1	2	9	1	1	15
OG0001387	3	1	3	2	1	5	15
OG0001388	2	1	1	9	0	2	15
OG0001389	2	1	3	7	1	1	15
OG0001390	3	1	1	8	1	1	15
OG0001391	3	1	1	8	1	1	15
OG0001392	1	1	1	10	1	1	15
OG0001393	3	1	2	7	1	1	15
OG0001394	5	1	1	6	1	1	15
OG0001395	2	1	1	10	0	1	15
OG0001396	2	0	0	10	1	2	15
OG0001397	3	1	7	2	1	1	15
OG0001398	2	1	0	10	1	1	15
OG0001399	4	1	1	7	1	1	15
OG0001400	3	1	1	8	1	1	15
OG0001401	3	1	1	8	1	1	15
OG0001402	1	1	6	6	0	1	15
OG0001403	3	1	1	8	1	1	15
OG0001404	3	1	1	8	1	1	15
OG0001405	1	0	0	14	0	0	15
OG0001406	1	1	1	10	1	1	15
OG0001407	1	0	1	11	1	1	15
OG0001408	1	1	1	10	1	1	15
OG0001409	1	0	4	8	1	1	15
OG0001410	1	2	2	6	2	2	15
OG0001411	2	0	1	11	0	1	15
OG0001412	2	0	1	11	0	1	15
OG0001413	1	2	9	0	1	2	15
OG0001414	1	1	1	10	1	1	15
OG0001415	1	1	1	10	1	1	15
OG0001416	4	0	0	11	0	0	15
OG0001417	2	0	7	5	1	0	15
OG0001418	2	1	1	10	0	1	15
OG0001419	1	1	1	10	1	1	15
OG0001420	1	0	1	11	1	1	15
OG0001421	1	0	1	13	0	0	15
OG0001422	1	1	1	10	1	1	15
OG0001423	5	1	1	6	1	1	15
OG0001424	1	0	1	11	1	1	15
OG0001425	1	1	1	10	1	1	15
OG0001426	1	1	1	10	1	1	15
OG0001427	4	1	1	7	1	1	15
OG0001428	2	0	1	10	1	1	15
OG0001429	1	0	1	12	0	1	15
OG0001430	2	1	1	9	1	1	15
OG0001431	0	1	1	11	1	1	15
OG0001432	0	1	0	11	1	2	15
OG0001433	0	0	13	0	1	1	15
OG0001434	0	0	1	12	1	1	15
OG0001435	0	0	1	12	1	1	15
OG0001436	0	0	1	12	1	1	15
OG0001437	0	0	0	15	0	0	15
OG0001438	2	1	2	7	1	1	14
OG0001439	2	1	1	8	1	1	14
OG0001440	3	0	2	8	0	1	14
OG0001441	2	1	1	8	1	1	14
OG0001442	3	0	1	8	1	1	14
OG0001443	5	0	1	7	0	1	14
OG0001444	3	1	1	7	1	1	14
OG0001445	7	1	2	2	1	1	14
OG0001446	2	1	1	8	1	1	14
OG0001447	6	0	1	6	1	0	14
OG0001448	2	1	1	8	1	1	14
OG0001449	1	1	1	9	1	1	14
OG0001450	7	0	4	0	1	2	14
OG0001451	3	1	1	7	1	1	14
OG0001452	1	0	1	11	0	1	14
OG0001453	2	1	1	8	1	1	14
OG0001454	1	0	4	8	0	1	14
OG0001455	3	0	2	8	0	1	14
OG0001456	4	0	2	6	1	1	14
OG0001457	2	0	2	8	1	1	14
OG0001458	1	1	1	9	1	1	14
OG0001459	6	0	1	4	1	2	14
OG0001460	2	1	1	8	1	1	14
OG0001461	5	0	1	6	1	1	14
OG0001462	5	0	1	6	1	1	14
OG0001463	6	0	1	5	1	1	14
OG0001464	4	1	1	6	1	1	14
OG0001465	3	0	1	8	1	1	14
OG0001466	2	1	1	8	1	1	14
OG0001467	5	2	1	4	1	1	14
OG0001468	2	1	1	8	1	1	14
OG0001469	5	1	2	4	1	1	14
OG0001470	5	1	4	2	1	1	14
OG0001471	4	0	0	10	0	0	14
OG0001472	2	1	1	8	1	1	14
OG0001473	2	0	1	10	0	1	14
OG0001474	4	1	1	6	1	1	14
OG0001475	4	1	1	6	1	1	14
OG0001476	1	0	1	11	0	1	14
OG0001477	6	0	5	2	0	1	14
OG0001478	4	1	1	6	1	1	14
OG0001479	1	0	1	10	1	1	14
OG0001480	2	0	1	9	1	1	14
OG0001481	4	1	1	6	1	1	14
OG0001482	2	1	1	8	1	1	14
OG0001483	2	1	1	8	1	1	14
OG0001484	3	1	0	9	0	1	14
OG0001485	4	1	1	6	1	1	14
OG0001486	1	0	0	11	1	1	14
OG0001487	3	1	0	8	1	1	14
OG0001488	4	1	1	6	1	1	14
OG0001489	8	0	2	4	0	0	14
OG0001490	6	1	1	4	1	1	14
OG0001491	4	1	1	7	0	1	14
OG0001492	3	1	1	6	1	2	14
OG0001493	4	2	2	2	2	2	14
OG0001494	2	1	1	8	1	1	14
OG0001495	2	1	1	8	1	1	14
OG0001496	3	1	1	7	1	1	14
OG0001497	3	0	1	8	1	1	14
OG0001498	5	0	1	7	0	1	14
OG0001499	4	0	2	4	2	2	14
OG0001500	3	0	1	8	1	1	14
OG0001501	1	0	0	13	0	0	14
OG0001502	4	1	1	6	1	1	14
OG0001503	2	1	1	8	1	1	14
OG0001504	2	1	3	6	1	1	14
OG0001505	10	1	1	2	0	0	14
OG0001506	5	0	1	6	1	1	14
OG0001507	2	1	1	8	1	1	14
OG0001508	3	1	1	7	1	1	14
OG0001509	5	0	1	6	1	1	14
OG0001510	2	1	1	8	0	2	14
OG0001511	3	1	1	7	1	1	14
OG0001512	3	1	2	5	1	2	14
OG0001513	2	1	1	8	1	1	14
OG0001514	10	0	2	2	0	0	14
OG0001515	7	0	4	2	1	0	14
OG0001516	5	1	2	4	1	1	14
OG0001517	6	1	1	2	2	2	14
OG0001518	2	1	1	8	1	1	14
OG0001519	2	1	1	8	1	1	14
OG0001520	4	0	1	8	0	1	14
OG0001521	2	0	1	10	0	1	14
OG0001522	3	1	1	7	1	1	14
OG0001523	2	0	4	6	1	1	14
OG0001524	4	0	3	7	0	0	14
OG0001525	3	1	2	6	1	1	14
OG0001526	2	1	1	8	1	1	14
OG0001527	6	1	1	4	1	1	14
OG0001528	4	1	1	6	1	1	14
OG0001529	3	0	1	8	1	1	14
OG0001530	2	0	2	8	0	2	14
OG0001531	6	1	1	4	1	1	14
OG0001532	6	1	1	4	1	1	14
OG0001533	3	1	0	8	1	1	14
OG0001534	2	1	1	8	1	1	14
OG0001535	6	0	1	5	1	1	14
OG0001536	5	0	1	8	0	0	14
OG0001537	4	2	1	6	0	1	14
OG0001538	2	1	1	8	1	1	14
OG0001539	4	0	3	5	1	1	14
OG0001540	5	0	1	6	1	1	14
OG0001541	8	1	1	2	1	1	14
OG0001542	2	0	1	10	0	1	14
OG0001543	8	0	1	3	1	1	14
OG0001544	1	0	2	10	0	1	14
OG0001545	6	1	2	3	1	1	14
OG0001546	3	1	1	7	1	1	14
OG0001547	8	1	1	1	1	2	14
OG0001548	14	0	0	0	0	0	14
OG0001549	1	0	1	10	1	1	14
OG0001550	4	0	3	7	0	0	14
OG0001551	3	0	0	11	0	0	14
OG0001552	3	0	2	8	1	0	14
OG0001553	1	1	3	7	1	1	14
OG0001554	6	0	4	2	1	1	14
OG0001555	4	1	1	6	1	1	14
OG0001556	2	1	2	8	0	1	14
OG0001557	2	1	1	8	1	1	14
OG0001558	1	0	1	10	1	1	14
OG0001559	3	1	1	7	1	1	14
OG0001560	2	0	2	8	1	1	14
OG0001561	1	1	1	9	1	1	14
OG0001562	1	0	10	0	1	2	14
OG0001563	3	0	3	4	2	2	14
OG0001564	4	1	1	6	1	1	14
OG0001565	4	1	1	6	1	1	14
OG0001566	1	0	1	10	1	1	14
OG0001567	2	1	1	8	1	1	14
OG0001568	2	1	1	8	1	1	14
OG0001569	2	1	1	8	1	1	14
OG0001570	2	1	1	8	1	1	14
OG0001571	2	1	0	8	0	3	14
OG0001572	1	0	1	12	0	0	14
OG0001573	1	1	1	9	1	1	14
OG0001574	2	0	1	9	1	1	14
OG0001575	4	0	1	7	1	1	14
OG0001576	3	1	3	4	1	2	14
OG0001577	1	0	0	13	0	0	14
OG0001578	4	1	2	5	1	1	14
OG0001579	2	0	1	9	1	1	14
OG0001580	1	1	1	8	2	1	14
OG0001581	1	1	2	8	1	1	14
OG0001582	3	0	1	8	1	1	14
OG0001583	1	0	1	10	1	1	14
OG0001584	1	1	1	9	1	1	14
OG0001585	2	1	2	7	1	1	14
OG0001586	2	1	1	8	1	1	14
OG0001587	1	0	2	11	0	0	14
OG0001588	2	1	8	0	1	2	14
OG0001589	2	1	1	8	1	1	14
OG0001590	1	0	1	10	1	1	14
OG0001591	2	0	1	9	1	1	14
OG0001592	1	0	1	10	1	1	14
OG0001593	1	1	1	9	1	1	14
OG0001594	4	0	3	6	0	1	14
OG0001595	1	0	2	10	0	1	14
OG0001596	1	0	1	11	0	1	14
OG0001597	1	0	0	13	0	0	14
OG0001598	1	1	1	9	1	1	14
OG0001599	2	0	1	9	1	1	14
OG0001600	0	1	0	12	0	1	14
OG0001601	0	3	5	4	1	1	14
OG0001602	0	1	3	0	8	2	14
OG0001603	0	1	0	12	1	0	14
OG0001604	0	0	13	0	1	0	14
OG0001605	0	0	3	9	1	1	14
OG0001606	0	0	14	0	0	0	14
OG0001607	0	0	14	0	0	0	14
OG0001608	0	0	1	11	1	1	14
OG0001609	0	0	2	10	1	1	14
OG0001610	0	0	1	13	0	0	14
OG0001611	0	0	1	11	1	1	14
OG0001612	0	0	1	11	1	1	14
OG0001613	0	0	0	0	0	14	14
OG0001614	1	1	1	8	1	1	13
OG0001615	3	1	1	6	1	1	13
OG0001616	2	0	0	11	0	0	13
OG0001617	8	2	1	0	1	1	13
OG0001618	5	0	1	6	1	0	13
OG0001619	2	1	3	5	1	1	13
OG0001620	2	0	1	10	0	0	13
OG0001621	4	1	1	4	2	1	13
OG0001622	1	0	3	8	0	1	13
OG0001623	2	1	1	7	1	1	13
OG0001624	6	0	1	4	0	2	13
OG0001625	3	1	1	6	1	1	13
OG0001626	3	1	1	6	1	1	13
OG0001627	2	1	1	7	1	1	13
OG0001628	3	0	2	7	0	1	13
OG0001629	2	1	4	4	1	1	13
OG0001630	6	0	1	4	1	1	13
OG0001631	1	0	2	8	1	1	13
OG0001632	3	0	1	7	1	1	13
OG0001633	1	1	1	8	1	1	13
OG0001634	8	0	1	4	0	0	13
OG0001635	2	0	1	9	0	1	13
OG0001636	4	1	1	6	0	1	13
OG0001637	1	0	1	11	0	0	13
OG0001638	1	0	2	9	0	1	13
OG0001639	2	1	1	7	1	1	13
OG0001640	2	0	1	8	1	1	13
OG0001641	2	2	3	2	2	2	13
OG0001642	2	1	1	7	1	1	13
OG0001643	4	1	0	8	0	0	13
OG0001644	3	1	1	6	1	1	13
OG0001645	1	1	1	8	1	1	13
OG0001646	5	1	4	2	0	1	13
OG0001647	2	1	1	8	0	1	13
OG0001648	4	1	1	5	1	1	13
OG0001649	10	0	1	1	0	1	13
OG0001650	2	1	1	7	1	1	13
OG0001651	2	0	4	4	1	2	13
OG0001652	2	0	1	9	0	1	13
OG0001653	6	0	1	4	1	1	13
OG0001654	1	0	3	7	0	2	13
OG0001655	3	1	1	6	1	1	13
OG0001656	4	1	1	5	1	1	13
OG0001657	5	1	1	4	1	1	13
OG0001658	4	0	1	6	1	1	13
OG0001659	6	0	2	4	0	1	13
OG0001660	1	0	1	8	1	2	13
OG0001661	1	1	1	7	2	1	13
OG0001662	2	0	1	10	0	0	13
OG0001663	1	0	1	8	1	2	13
OG0001664	3	0	1	7	1	1	13
OG0001665	2	1	4	4	1	1	13
OG0001666	1	0	10	1	0	1	13
OG0001667	1	1	1	8	1	1	13
OG0001668	4	1	1	5	1	1	13
OG0001669	3	1	1	6	1	1	13
OG0001670	2	0	1	9	0	1	13
OG0001671	2	1	2	6	1	1	13
OG0001672	2	0	0	9	1	1	13
OG0001673	4	0	1	6	1	1	13
OG0001674	12	0	1	0	0	0	13
OG0001675	5	1	1	4	1	1	13
OG0001676	4	0	1	6	1	1	13
OG0001677	3	1	1	6	1	1	13
OG0001678	3	1	1	6	1	1	13
OG0001679	3	1	2	5	1	1	13
OG0001680	6	1	1	3	1	1	13
OG0001681	8	0	1	2	1	1	13
OG0001682	8	0	1	4	0	0	13
OG0001683	10	1	1	0	1	0	13
OG0001684	6	0	1	4	1	1	13
OG0001685	2	1	3	4	1	2	13
OG0001686	5	1	1	4	1	1	13
OG0001687	4	0	1	6	1	1	13
OG0001688	3	0	6	0	2	2	13
OG0001689	3	1	1	6	1	1	13
OG0001690	4	0	3	4	0	2	13
OG0001691	1	1	1	8	1	1	13
OG0001692	4	0	1	6	1	1	13
OG0001693	3	1	0	9	0	0	13
OG0001694	4	1	1	5	1	1	13
OG0001695	3	0	0	10	0	0	13
OG0001696	6	0	0	6	0	1	13
OG0001697	11	0	2	0	0	0	13
OG0001698	1	1	1	8	1	1	13
OG0001699	1	0	0	12	0	0	13
OG0001700	3	0	0	10	0	0	13
OG0001701	1	0	0	10	1	1	13
OG0001702	1	2	2	8	0	0	13
OG0001703	1	0	0	12	0	0	13
OG0001704	3	1	1	6	1	1	13
OG0001705	3	1	1	6	1	1	13
OG0001706	4	1	1	5	1	1	13
OG0001707	3	1	1	6	1	1	13
OG0001708	2	0	1	8	1	1	13
OG0001709	1	1	7	2	0	2	13
OG0001710	4	0	1	6	1	1	13
OG0001711	2	0	0	11	0	0	13
OG0001712	2	1	1	7	1	1	13
OG0001713	5	0	0	4	1	3	13
OG0001714	3	2	2	4	1	1	13
OG0001715	2	1	7	2	0	1	13
OG0001716	1	1	1	8	1	1	13
OG0001717	3	1	1	6	1	1	13
OG0001718	3	1	1	6	1	1	13
OG0001719	3	0	1	8	0	1	13
OG0001720	1	1	2	8	0	1	13
OG0001721	3	1	1	6	1	1	13
OG0001722	1	1	7	0	2	2	13
OG0001723	1	1	2	7	1	1	13
OG0001724	1	1	1	8	1	1	13
OG0001725	1	0	0	12	0	0	13
OG0001726	1	1	7	0	3	1	13
OG0001727	2	0	1	8	1	1	13
OG0001728	1	0	3	6	2	1	13
OG0001729	1	0	1	10	1	0	13
OG0001730	2	0	3	7	0	1	13
OG0001731	2	0	1	8	1	1	13
OG0001732	2	1	2	6	1	1	13
OG0001733	1	1	2	7	1	1	13
OG0001734	1	0	1	10	0	1	13
OG0001735	2	0	2	7	1	1	13
OG0001736	1	2	2	6	1	1	13
OG0001737	3	1	1	6	1	1	13
OG0001738	2	0	1	8	1	1	13
OG0001739	2	1	0	8	1	1	13
OG0001740	2	0	2	6	1	2	13
OG0001741	1	1	1	8	1	1	13
OG0001742	1	1	3	6	1	1	13
OG0001743	2	1	1	6	2	1	13
OG0001744	2	1	1	8	1	0	13
OG0001745	1	1	1	9	0	1	13
OG0001746	3	1	1	6	1	1	13
OG0001747	3	1	1	6	1	1	13
OG0001748	1	0	1	9	1	1	13
OG0001749	1	0	0	11	0	1	13
OG0001750	2	1	2	6	1	1	13
OG0001751	1	0	1	9	1	1	13
OG0001752	2	0	2	8	0	1	13
OG0001753	1	0	1	10	1	0	13
OG0001754	1	1	1	8	1	1	13
OG0001755	2	0	1	8	1	1	13
OG0001756	3	1	1	6	1	1	13
OG0001757	1	1	1	8	1	1	13
OG0001758	3	1	1	6	1	1	13
OG0001759	0	1	1	10	0	1	13
OG0001760	0	7	3	0	2	1	13
OG0001761	0	1	1	9	1	1	13
OG0001762	0	1	0	10	1	1	13
OG0001763	0	0	3	0	1	9	13
OG0001764	0	0	13	0	0	0	13
OG0001765	0	0	12	1	0	0	13
OG0001766	0	0	12	0	1	0	13
OG0001767	0	0	1	12	0	0	13
OG0001768	0	0	1	10	1	1	13
OG0001769	0	0	1	12	0	0	13
OG0001770	0	0	0	11	1	1	13
OG0001771	0	0	0	11	1	1	13
OG0001772	0	0	0	13	0	0	13
OG0001773	2	1	1	6	1	1	12
OG0001774	3	1	1	6	0	1	12
OG0001775	5	0	3	2	1	1	12
OG0001776	3	0	1	6	1	1	12
OG0001777	1	1	1	7	1	1	12
OG0001778	3	2	1	4	1	1	12
OG0001779	2	1	2	5	1	1	12
OG0001780	2	1	5	4	0	0	12
OG0001781	3	1	1	6	0	1	12
OG0001782	3	1	1	6	0	1	12
OG0001783	4	0	1	6	0	1	12
OG0001784	11	0	1	0	0	0	12
OG0001785	4	0	1	5	1	1	12
OG0001786	2	1	0	7	1	1	12
OG0001787	1	0	3	6	1	1	12
OG0001788	6	0	1	3	1	1	12
OG0001789	2	0	1	9	0	0	12
OG0001790	2	1	1	6	1	1	12
OG0001791	4	1	1	4	1	1	12
OG0001792	7	1	1	2	0	1	12
OG0001793	3	1	2	4	1	1	12
OG0001794	4	1	1	4	1	1	12
OG0001795	1	0	4	7	0	0	12
OG0001796	2	0	0	10	0	0	12
OG0001797	1	0	11	0	0	0	12
OG0001798	2	0	1	7	1	1	12
OG0001799	5	0	1	4	1	1	12
OG0001800	6	1	0	4	0	1	12
OG0001801	4	0	1	6	0	1	12
OG0001802	6	1	1	2	1	1	12
OG0001803	2	1	0	7	1	1	12
OG0001804	4	1	1	4	1	1	12
OG0001805	2	1	1	6	1	1	12
OG0001806	1	0	1	8	2	0	12
OG0001807	1	1	1	7	1	1	12
OG0001808	2	1	1	6	0	2	12
OG0001809	2	1	1	6	1	1	12
OG0001810	3	1	1	5	1	1	12
OG0001811	2	0	0	9	0	1	12
OG0001812	5	0	1	6	0	0	12
OG0001813	2	0	1	7	1	1	12
OG0001814	2	1	1	6	1	1	12
OG0001815	1	1	0	8	1	1	12
OG0001816	2	1	1	6	1	1	12
OG0001817	3	1	2	4	1	1	12
OG0001818	6	0	0	6	0	0	12
OG0001819	4	1	1	4	1	1	12
OG0001820	2	1	1	6	1	1	12
OG0001821	2	1	0	8	0	1	12
OG0001822	3	1	1	5	1	1	12
OG0001823	3	1	2	4	1	1	12
OG0001824	3	1	2	4	1	1	12
OG0001825	1	1	2	7	1	0	12
OG0001826	4	1	1	4	1	1	12
OG0001827	5	1	0	4	1	1	12
OG0001828	2	1	1	6	1	1	12
OG0001829	2	1	1	6	1	1	12
OG0001830	2	1	1	6	1	1	12
OG0001831	2	1	1	6	1	1	12
OG0001832	4	1	1	4	1	1	12
OG0001833	8	1	2	0	0	1	12
OG0001834	2	1	1	8	0	0	12
OG0001835	3	0	1	6	1	1	12
OG0001836	3	2	2	4	0	1	12
OG0001837	2	1	1	6	1	1	12
OG0001838	6	0	2	0	2	2	12
OG0001839	6	0	0	5	0	1	12
OG0001840	1	1	1	7	1	1	12
OG0001841	9	0	2	0	1	0	12
OG0001842	2	1	1	6	1	1	12
OG0001843	3	0	1	6	1	1	12
OG0001844	1	0	1	8	1	1	12
OG0001845	4	1	0	6	0	1	12
OG0001846	3	0	0	9	0	0	12
OG0001847	2	1	1	6	1	1	12
OG0001848	4	1	1	4	1	1	12
OG0001849	1	1	2	6	1	1	12
OG0001850	7	0	1	2	1	1	12
OG0001851	3	0	1	7	0	1	12
OG0001852	4	1	1	4	1	1	12
OG0001853	4	1	1	4	1	1	12
OG0001854	7	0	0	5	0	0	12
OG0001855	2	1	1	6	1	1	12
OG0001856	2	1	1	6	1	1	12
OG0001857	2	0	1	8	0	1	12
OG0001858	4	1	1	4	1	1	12
OG0001859	1	0	0	11	0	0	12
OG0001860	4	1	1	4	1	1	12
OG0001861	7	0	3	0	1	1	12
OG0001862	2	0	0	10	0	0	12
OG0001863	7	1	1	2	1	0	12
OG0001864	6	0	1	4	0	1	12
OG0001865	4	1	1	4	1	1	12
OG0001866	4	0	2	6	0	0	12
OG0001867	3	1	2	4	1	1	12
OG0001868	7	0	1	4	0	0	12
OG0001869	1	0	0	11	0	0	12
OG0001870	6	1	1	2	1	1	12
OG0001871	5	0	1	6	0	0	12
OG0001872	6	0	1	4	0	1	12
OG0001873	5	0	0	6	0	1	12
OG0001874	11	0	0	0	0	1	12
OG0001875	3	0	0	6	1	2	12
OG0001876	10	0	1	1	0	0	12
OG0001877	1	1	4	4	1	1	12
OG0001878	8	0	0	2	0	2	12
OG0001879	3	1	1	6	0	1	12
OG0001880	5	0	3	2	1	1	12
OG0001881	6	0	2	3	0	1	12
OG0001882	2	1	1	6	1	1	12
OG0001883	2	1	1	6	1	1	12
OG0001884	2	0	1	9	0	0	12
OG0001885	5	0	1	4	1	1	12
OG0001886	6	0	1	3	1	1	12
OG0001887	4	1	1	4	1	1	12
OG0001888	5	0	2	4	0	1	12
OG0001889	4	0	1	5	1	1	12
OG0001890	3	1	1	6	0	1	12
OG0001891	1	1	1	6	1	2	12
OG0001892	6	1	3	0	0	2	12
OG0001893	3	0	1	8	0	0	12
OG0001894	1	0	0	11	0	0	12
OG0001895	11	0	0	0	0	1	12
OG0001896	4	0	0	7	0	1	12
OG0001897	10	0	0	0	1	1	12
OG0001898	2	1	1	6	1	1	12
OG0001899	6	1	1	2	1	1	12
OG0001900	5	1	1	4	0	1	12
OG0001901	5	0	0	7	0	0	12
OG0001902	2	1	2	4	1	2	12
OG0001903	3	0	3	6	0	0	12
OG0001904	4	1	1	4	1	1	12
OG0001905	3	1	1	5	1	1	12
OG0001906	1	0	2	8	1	0	12
OG0001907	2	1	1	6	1	1	12
OG0001908	6	1	1	2	1	1	12
OG0001909	2	0	0	8	2	0	12
OG0001910	1	0	1	8	1	1	12
OG0001911	4	0	1	5	1	1	12
OG0001912	1	0	1	10	0	0	12
OG0001913	2	1	1	6	1	1	12
OG0001914	3	0	0	4	1	4	12
OG0001915	1	0	1	8	1	1	12
OG0001916	1	0	1	10	0	0	12
OG0001917	2	1	1	6	1	1	12
OG0001918	1	0	1	8	1	1	12
OG0001919	2	0	0	10	0	0	12
OG0001920	3	1	1	5	0	2	12
OG0001921	2	0	1	7	0	2	12
OG0001922	2	1	4	4	0	1	12
OG0001923	1	0	1	8	1	1	12
OG0001924	3	1	2	4	1	1	12
OG0001925	1	0	1	8	1	1	12
OG0001926	4	0	1	5	1	1	12
OG0001927	1	1	1	7	1	1	12
OG0001928	2	1	1	6	1	1	12
OG0001929	1	1	2	6	1	1	12
OG0001930	1	0	1	8	1	1	12
OG0001931	2	1	1	6	1	1	12
OG0001932	2	0	1	8	0	1	12
OG0001933	3	2	3	0	1	3	12
OG0001934	1	1	3	4	1	2	12
OG0001935	1	1	1	7	1	1	12
OG0001936	2	1	1	6	1	1	12
OG0001937	2	1	1	6	1	1	12
OG0001938	1	1	0	10	0	0	12
OG0001939	2	2	1	6	0	1	12
OG0001940	2	0	1	8	0	1	12
OG0001941	4	0	0	6	1	1	12
OG0001942	1	1	2	6	1	1	12
OG0001943	1	0	1	8	1	1	12
OG0001944	4	0	2	4	1	1	12
OG0001945	2	1	2	4	1	2	12
OG0001946	4	0	2	4	1	1	12
OG0001947	1	2	1	6	1	1	12
OG0001948	1	0	1	8	1	1	12
OG0001949	4	1	3	2	1	1	12
OG0001950	2	0	0	10	0	0	12
OG0001951	2	1	1	6	1	1	12
OG0001952	1	0	2	8	0	1	12
OG0001953	1	0	2	9	0	0	12
OG0001954	1	1	1	7	1	1	12
OG0001955	1	1	4	4	1	1	12
OG0001956	1	0	5	5	0	1	12
OG0001957	1	0	1	8	1	1	12
OG0001958	2	0	4	4	1	1	12
OG0001959	1	1	2	6	1	1	12
OG0001960	2	1	4	4	0	1	12
OG0001961	3	0	1	6	1	1	12
OG0001962	2	1	2	4	2	1	12
OG0001963	4	0	1	4	2	1	12
OG0001964	5	1	2	4	0	0	12
OG0001965	4	1	1	6	0	0	12
OG0001966	1	1	1	7	1	1	12
OG0001967	2	0	1	8	0	1	12
OG0001968	2	0	1	7	1	1	12
OG0001969	6	0	1	4	0	1	12
OG0001970	1	1	1	8	0	1	12
OG0001971	2	1	1	6	1	1	12
OG0001972	1	0	0	10	0	1	12
OG0001973	1	1	1	7	1	1	12
OG0001974	2	0	5	4	1	0	12
OG0001975	2	0	2	6	1	1	12
OG0001976	1	0	1	8	1	1	12
OG0001977	3	0	1	6	1	1	12
OG0001978	1	1	3	5	1	1	12
OG0001979	1	0	1	8	1	1	12
OG0001980	0	1	1	8	1	1	12
OG0001981	0	3	4	0	4	1	12
OG0001982	0	1	1	8	1	1	12
OG0001983	0	0	1	8	2	1	12
OG0001984	0	0	1	9	1	1	12
OG0001985	0	0	1	11	0	0	12
OG0001986	0	0	3	7	1	1	12
OG0001987	0	0	1	9	1	1	12
OG0001988	0	0	1	10	0	1	12
OG0001989	0	0	1	11	0	0	12
OG0001990	0	0	0	3	9	0	12
OG0001991	0	0	0	11	0	1	12
OG0001992	0	0	0	0	10	2	12
OG0001993	1	0	0	8	1	1	11
OG0001994	3	0	0	7	0	1	11
OG0001995	3	1	1	4	1	1	11
OG0001996	2	0	0	7	1	1	11
OG0001997	5	1	1	2	1	1	11
OG0001998	1	1	1	6	1	1	11
OG0001999	1	1	3	0	3	3	11
OG0002000	2	0	1	6	1	1	11
OG0002001	2	1	2	4	1	1	11
OG0002002	2	0	1	8	0	0	11
OG0002003	2	1	2	4	1	1	11
OG0002004	2	0	2	5	1	1	11
OG0002005	5	0	1	4	0	1	11
OG0002006	2	0	2	3	0	4	11
OG0002007	1	1	1	6	1	1	11
OG0002008	3	1	1	4	1	1	11
OG0002009	1	1	1	6	1	1	11
OG0002010	2	0	1	6	1	1	11
OG0002011	3	0	2	4	1	1	11
OG0002012	1	0	1	8	0	1	11
OG0002013	2	1	0	6	1	1	11
OG0002014	2	0	1	6	1	1	11
OG0002015	1	1	1	6	1	1	11
OG0002016	4	0	1	4	1	1	11
OG0002017	1	1	1	6	1	1	11
OG0002018	3	0	1	5	1	1	11
OG0002019	1	1	1	6	1	1	11
OG0002020	3	0	1	5	1	1	11
OG0002021	2	0	2	5	1	1	11
OG0002022	1	1	1	6	1	1	11
OG0002023	1	1	1	6	1	1	11
OG0002024	1	0	2	8	0	0	11
OG0002025	2	1	6	0	1	1	11
OG0002026	2	0	1	6	1	1	11
OG0002027	3	0	2	4	1	1	11
OG0002028	4	1	1	4	0	1	11
OG0002029	2	0	1	6	1	1	11
OG0002030	1	1	1	6	1	1	11
OG0002031	1	0	1	8	1	0	11
OG0002032	4	1	1	3	1	1	11
OG0002033	2	0	1	5	0	3	11
OG0002034	4	1	3	0	2	1	11
OG0002035	2	0	1	6	1	1	11
OG0002036	3	1	1	4	1	1	11
OG0002037	2	1	1	5	1	1	11
OG0002038	1	1	1	6	1	1	11
OG0002039	1	1	1	7	1	0	11
OG0002040	3	0	1	6	0	1	11
OG0002041	1	0	0	10	0	0	11
OG0002042	4	1	0	4	1	1	11
OG0002043	4	0	1	6	0	0	11
OG0002044	2	0	1	6	0	2	11
OG0002045	6	0	1	2	1	1	11
OG0002046	4	1	1	4	0	1	11
OG0002047	2	1	0	6	1	1	11
OG0002048	1	1	1	6	1	1	11
OG0002049	6	1	2	0	1	1	11
OG0002050	1	1	1	6	1	1	11
OG0002051	1	1	1	6	1	1	11
OG0002052	3	0	0	6	1	1	11
OG0002053	2	1	1	5	1	1	11
OG0002054	1	0	0	10	0	0	11
OG0002055	3	1	1	4	1	1	11
OG0002056	7	1	1	0	1	1	11
OG0002057	2	0	0	9	0	0	11
OG0002058	2	1	1	4	1	2	11
OG0002059	3	1	1	4	1	1	11
OG0002060	4	1	1	3	1	1	11
OG0002061	4	0	3	2	1	1	11
OG0002062	5	0	1	4	0	1	11
OG0002063	3	0	1	5	1	1	11
OG0002064	1	0	2	8	0	0	11
OG0002065	1	0	0	10	0	0	11
OG0002066	11	0	0	0	0	0	11
OG0002067	8	1	1	0	0	1	11
OG0002068	1	0	0	10	0	0	11
OG0002069	1	0	0	10	0	0	11
OG0002070	1	1	1	8	0	0	11
OG0002071	6	0	1	2	1	1	11
OG0002072	2	1	1	6	0	1	11
OG0002073	2	0	1	7	1	0	11
OG0002074	3	1	1	4	1	1	11
OG0002075	3	1	1	4	1	1	11
OG0002076	2	1	1	5	1	1	11
OG0002077	5	1	1	2	1	1	11
OG0002078	2	1	1	5	1	1	11
OG0002079	1	0	1	7	1	1	11
OG0002080	6	0	1	0	1	3	11
OG0002081	6	0	1	2	1	1	11
OG0002082	2	0	4	2	2	1	11
OG0002083	6	0	3	0	1	1	11
OG0002084	3	1	2	3	1	1	11
OG0002085	6	1	3	0	0	1	11
OG0002086	9	0	1	0	0	1	11
OG0002087	4	0	2	3	1	1	11
OG0002088	6	0	1	2	1	1	11
OG0002089	2	1	5	2	1	0	11
OG0002090	3	0	2	5	0	1	11
OG0002091	4	1	1	2	1	2	11
OG0002092	4	0	1	2	2	2	11
OG0002093	6	0	1	4	0	0	11
OG0002094	1	1	1	6	1	1	11
OG0002095	4	0	0	7	0	0	11
OG0002096	1	0	0	10	0	0	11
OG0002097	2	0	0	8	0	1	11
OG0002098	3	1	1	4	1	1	11
OG0002099	4	0	1	4	1	1	11
OG0002100	3	1	0	6	0	1	11
OG0002101	2	0	1	6	1	1	11
OG0002102	3	1	2	4	0	1	11
OG0002103	3	0	1	6	0	1	11
OG0002104	2	1	2	4	1	1	11
OG0002105	1	0	1	7	1	1	11
OG0002106	3	0	0	8	0	0	11
OG0002107	3	0	1	7	0	0	11
OG0002108	3	1	1	4	1	1	11
OG0002109	8	0	1	0	1	1	11
OG0002110	4	1	1	4	0	1	11
OG0002111	5	0	1	4	0	1	11
OG0002112	8	0	1	0	1	1	11
OG0002113	3	1	1	4	1	1	11
OG0002114	5	1	1	2	1	1	11
OG0002115	2	0	1	8	0	0	11
OG0002116	5	1	1	2	1	1	11
OG0002117	1	0	10	0	0	0	11
OG0002118	1	0	4	2	2	2	11
OG0002119	2	1	1	5	1	1	11
OG0002120	1	1	0	8	0	1	11
OG0002121	5	1	1	0	2	2	11
OG0002122	4	0	1	4	1	1	11
OG0002123	2	0	1	7	0	1	11
OG0002124	5	0	2	2	1	1	11
OG0002125	1	1	1	6	1	1	11
OG0002126	1	0	2	4	2	2	11
OG0002127	1	1	1	6	1	1	11
OG0002128	1	1	1	7	0	1	11
OG0002129	4	1	1	3	1	1	11
OG0002130	4	1	1	3	1	1	11
OG0002131	4	1	1	4	0	1	11
OG0002132	3	1	1	4	1	1	11
OG0002133	2	1	0	8	0	0	11
OG0002134	1	1	1	6	1	1	11
OG0002135	2	0	0	6	2	1	11
OG0002136	3	1	1	4	1	1	11
OG0002137	2	1	1	5	1	1	11
OG0002138	2	0	1	6	1	1	11
OG0002139	2	0	1	6	1	1	11
OG0002140	3	0	3	4	0	1	11
OG0002141	3	1	3	0	2	2	11
OG0002142	2	0	6	0	1	2	11
OG0002143	2	1	0	7	0	1	11
OG0002144	2	1	5	2	0	1	11
OG0002145	1	1	1	6	1	1	11
OG0002146	1	0	1	7	1	1	11
OG0002147	3	3	1	2	1	1	11
OG0002148	1	1	1	7	1	0	11
OG0002149	1	0	1	6	1	2	11
OG0002150	3	0	1	6	0	1	11
OG0002151	1	1	1	6	1	1	11
OG0002152	1	1	1	6	1	1	11
OG0002153	2	0	1	6	1	1	11
OG0002154	3	1	1	4	1	1	11
OG0002155	3	2	3	2	0	1	11
OG0002156	1	1	1	6	1	1	11
OG0002157	1	1	1	6	1	1	11
OG0002158	1	0	0	10	0	0	11
OG0002159	2	0	3	4	1	1	11
OG0002160	3	0	1	6	0	1	11
OG0002161	1	1	2	4	2	1	11
OG0002162	1	0	1	7	1	1	11
OG0002163	2	1	4	2	1	1	11
OG0002164	2	1	2	2	2	2	11
OG0002165	1	1	1	6	1	1	11
OG0002166	1	0	1	9	0	0	11
OG0002167	1	1	2	5	1	1	11
OG0002168	2	1	2	4	1	1	11
OG0002169	1	0	1	9	0	0	11
OG0002170	2	1	1	6	0	1	11
OG0002171	2	0	1	6	1	1	11
OG0002172	1	1	1	6	1	1	11
OG0002173	1	1	1	6	1	1	11
OG0002174	1	1	1	6	1	1	11
OG0002175	1	1	2	4	1	2	11
OG0002176	1	0	1	8	0	1	11
OG0002177	1	1	1	6	1	1	11
OG0002178	2	0	1	6	1	1	11
OG0002179	1	0	1	7	1	1	11
OG0002180	1	0	8	0	1	1	11
OG0002181	1	1	0	7	1	1	11
OG0002182	4	0	1	4	1	1	11
OG0002183	3	1	1	4	1	1	11
OG0002184	2	0	1	6	1	1	11
OG0002185	2	1	1	5	1	1	11
OG0002186	2	1	2	4	1	1	11
OG0002187	1	1	1	6	1	1	11
OG0002188	2	1	1	5	1	1	11
OG0002189	2	1	1	5	1	1	11
OG0002190	2	1	3	3	1	1	11
OG0002191	4	1	1	4	0	1	11
OG0002192	2	0	1	6	1	1	11
OG0002193	6	1	2	2	0	0	11
OG0002194	2	0	1	6	1	1	11
OG0002195	2	0	0	7	1	1	11
OG0002196	3	0	0	8	0	0	11
OG0002197	2	1	0	6	1	1	11
OG0002198	1	0	1	7	1	1	11
OG0002199	3	1	1	4	1	1	11
OG0002200	1	1	2	5	0	2	11
OG0002201	2	0	1	7	0	1	11
OG0002202	4	0	1	4	1	1	11
OG0002203	3	1	1	4	1	1	11
OG0002204	3	0	1	6	0	1	11
OG0002205	1	1	1	6	1	1	11
OG0002206	1	1	1	6	1	1	11
OG0002207	1	0	1	7	1	1	11
OG0002208	2	1	0	6	1	1	11
OG0002209	1	0	1	7	1	1	11
OG0002210	2	0	1	6	1	1	11
OG0002211	1	1	1	6	1	1	11
OG0002212	1	1	1	6	1	1	11
OG0002213	3	1	1	4	1	1	11
OG0002214	3	1	1	4	1	1	11
OG0002215	1	1	2	4	1	2	11
OG0002216	2	1	2	5	0	1	11
OG0002217	1	0	1	9	0	0	11
OG0002218	1	1	2	4	1	2	11
OG0002219	2	0	1	6	1	1	11
OG0002220	0	1	1	7	1	1	11
OG0002221	0	0	4	6	0	1	11
OG0002222	0	0	1	9	0	1	11
OG0002223	0	0	1	8	1	1	11
OG0002224	0	0	1	10	0	0	11
OG0002225	0	0	1	8	1	1	11
OG0002226	0	0	0	10	1	0	11
OG0002227	0	0	0	0	0	11	11
OG0002228	5	1	2	0	1	1	10
OG0002229	4	1	0	3	1	1	10
OG0002230	2	1	1	4	1	1	10
OG0002231	4	0	2	4	0	0	10
OG0002232	2	1	1	4	1	1	10
OG0002233	4	0	2	4	0	0	10
OG0002234	3	0	0	7	0	0	10
OG0002235	2	1	1	4	1	1	10
OG0002236	2	1	1	4	1	1	10
OG0002237	1	0	2	5	1	1	10
OG0002238	3	1	1	4	0	1	10
OG0002239	1	0	1	8	0	0	10
OG0002240	4	1	1	2	1	1	10
OG0002241	2	1	1	4	1	1	10
OG0002242	2	1	1	4	1	1	10
OG0002243	2	1	1	4	1	1	10
OG0002244	3	0	0	5	1	1	10
OG0002245	4	0	1	3	1	1	10
OG0002246	1	1	4	2	1	1	10
OG0002247	5	0	1	2	1	1	10
OG0002248	2	2	3	2	0	1	10
OG0002249	2	1	1	4	1	1	10
OG0002250	5	0	0	4	0	1	10
OG0002251	2	0	2	4	1	1	10
OG0002252	1	0	0	9	0	0	10
OG0002253	2	1	1	4	1	1	10
OG0002254	5	0	1	2	1	1	10
OG0002255	2	0	0	7	0	1	10
OG0002256	3	1	1	3	1	1	10
OG0002257	1	1	1	5	1	1	10
OG0002258	5	0	1	2	1	1	10
OG0002259	1	1	1	6	0	1	10
OG0002260	1	0	1	6	1	1	10
OG0002261	2	0	0	6	1	1	10
OG0002262	3	0	1	4	1	1	10
OG0002263	3	1	2	2	1	1	10
OG0002264	3	1	1	3	1	1	10
OG0002265	1	1	2	4	1	1	10
OG0002266	4	0	2	2	1	1	10
OG0002267	2	1	2	3	1	1	10
OG0002268	1	0	1	6	1	1	10
OG0002269	2	0	1	7	0	0	10
OG0002270	1	0	0	8	0	1	10
OG0002271	2	1	1	4	1	1	10
OG0002272	4	0	0	4	1	1	10
OG0002273	3	0	2	5	0	0	10
OG0002274	1	1	0	4	1	3	10
OG0002275	2	1	1	4	1	1	10
OG0002276	2	1	1	4	1	1	10
OG0002277	2	0	3	3	1	1	10
OG0002278	2	0	1	6	0	1	10
OG0002279	5	0	1	2	0	2	10
OG0002280	2	1	1	4	1	1	10
OG0002281	2	1	1	4	1	1	10
OG0002282	6	0	1	2	0	1	10
OG0002283	1	0	0	9	0	0	10
OG0002284	1	0	1	6	1	1	10
OG0002285	2	0	1	6	0	1	10
OG0002286	1	0	1	8	0	0	10
OG0002287	1	0	1	7	0	1	10
OG0002288	2	1	3	2	1	1	10
OG0002289	3	0	1	4	1	1	10
OG0002290	1	1	1	5	1	1	10
OG0002291	6	0	0	2	1	1	10
OG0002292	4	1	1	2	1	1	10
OG0002293	6	0	1	2	0	1	10
OG0002294	3	0	1	5	1	0	10
OG0002295	5	1	1	2	0	1	10
OG0002296	5	1	1	2	0	1	10
OG0002297	2	1	1	4	1	1	10
OG0002298	2	0	1	6	0	1	10
OG0002299	6	0	0	2	1	1	10
OG0002300	4	1	2	2	0	1	10
OG0002301	4	1	1	2	1	1	10
OG0002302	3	0	1	4	1	1	10
OG0002303	1	0	0	8	0	1	10
OG0002304	2	0	0	8	0	0	10
OG0002305	1	0	1	6	1	1	10
OG0002306	4	0	1	4	0	1	10
OG0002307	1	0	1	6	1	1	10
OG0002308	3	1	2	2	1	1	10
OG0002309	4	0	0	6	0	0	10
OG0002310	2	1	1	4	1	1	10
OG0002311	2	0	1	5	1	1	10
OG0002312	2	1	1	4	1	1	10
OG0002313	2	1	1	4	1	1	10
OG0002314	5	0	1	3	0	1	10
OG0002315	3	1	2	2	1	1	10
OG0002316	1	0	4	3	1	1	10
OG0002317	2	1	1	4	1	1	10
OG0002318	4	0	0	6	0	0	10
OG0002319	3	0	0	5	1	1	10
OG0002320	1	1	1	5	1	1	10
OG0002321	4	1	1	2	1	1	10
OG0002322	1	1	1	5	1	1	10
OG0002323	6	0	3	0	0	1	10
OG0002324	4	1	1	2	1	1	10
OG0002325	7	1	0	0	1	1	10
OG0002326	7	1	0	0	1	1	10
OG0002327	3	1	1	3	1	1	10
OG0002328	3	1	1	4	0	1	10
OG0002329	4	0	0	4	1	1	10
OG0002330	2	0	0	7	0	1	10
OG0002331	3	0	1	4	1	1	10
OG0002332	3	0	1	5	0	1	10
OG0002333	6	1	1	0	1	1	10
OG0002334	2	1	1	4	1	1	10
OG0002335	4	1	0	4	0	1	10
OG0002336	5	1	0	3	1	0	10
OG0002337	2	1	1	4	1	1	10
OG0002338	2	1	1	4	1	1	10
OG0002339	2	1	1	4	1	1	10
OG0002340	4	1	0	3	1	1	10
OG0002341	2	0	0	8	0	0	10
OG0002342	5	0	1	2	1	1	10
OG0002343	2	1	1	4	1	1	10
OG0002344	5	0	1	2	1	1	10
OG0002345	2	0	0	8	0	0	10
OG0002346	5	0	1	2	1	1	10
OG0002347	3	0	2	5	0	0	10
OG0002348	1	0	9	0	0	0	10
OG0002349	3	0	0	7	0	0	10
OG0002350	1	1	6	0	1	1	10
OG0002351	2	2	2	2	1	1	10
OG0002352	2	1	1	4	1	1	10
OG0002353	1	1	1	5	1	1	10
OG0002354	2	1	1	5	0	1	10
OG0002355	4	1	1	2	1	1	10
OG0002356	4	0	3	0	1	2	10
OG0002357	1	2	1	0	3	3	10
OG0002358	2	1	1	4	1	1	10
OG0002359	1	0	2	4	2	1	10
OG0002360	1	0	1	6	1	1	10
OG0002361	1	1	1	6	0	1	10
OG0002362	2	1	1	2	2	2	10
OG0002363	1	0	0	8	1	0	10
OG0002364	1	0	1	8	0	0	10
OG0002365	2	0	0	8	0	0	10
OG0002366	3	1	1	4	0	1	10
OG0002367	1	1	2	5	1	0	10
OG0002368	2	1	1	4	1	1	10
OG0002369	5	0	1	2	1	1	10
OG0002370	3	1	4	0	1	1	10
OG0002371	1	0	1	7	0	1	10
OG0002372	1	1	4	1	2	1	10
OG0002373	1	1	1	4	2	1	10
OG0002374	3	0	1	5	0	1	10
OG0002375	1	0	0	9	0	0	10
OG0002376	5	0	2	2	0	1	10
OG0002377	2	0	2	2	2	2	10
OG0002378	1	1	2	4	0	2	10
OG0002379	2	1	1	4	1	1	10
OG0002380	1	1	2	4	1	1	10
OG0002381	3	1	1	3	1	1	10
OG0002382	2	1	1	4	1	1	10
OG0002383	3	1	2	2	1	1	10
OG0002384	1	0	7	0	1	1	10
OG0002385	1	1	1	6	0	1	10
OG0002386	2	1	2	2	2	1	10
OG0002387	1	0	2	6	0	1	10
OG0002388	1	1	2	4	1	1	10
OG0002389	1	0	5	4	0	0	10
OG0002390	4	0	0	6	0	0	10
OG0002391	2	1	1	4	1	1	10
OG0002392	4	0	2	2	1	1	10
OG0002393	1	1	2	5	0	1	10
OG0002394	2	0	1	5	1	1	10
OG0002395	1	0	0	9	0	0	10
OG0002396	2	1	1	4	1	1	10
OG0002397	3	0	1	4	1	1	10
OG0002398	2	0	3	4	0	1	10
OG0002399	1	0	1	6	1	1	10
OG0002400	1	0	3	4	1	1	10
OG0002401	1	1	1	4	1	2	10
OG0002402	6	1	1	0	1	1	10
OG0002403	2	1	1	4	1	1	10
OG0002404	2	0	1	5	1	1	10
OG0002405	1	0	0	9	0	0	10
OG0002406	2	0	3	2	1	2	10
OG0002407	1	0	1	6	1	1	10
OG0002408	2	1	1	4	1	1	10
OG0002409	2	1	1	4	1	1	10
OG0002410	1	1	2	4	1	1	10
OG0002411	1	0	1	6	1	1	10
OG0002412	6	1	1	0	1	1	10
OG0002413	2	1	1	4	1	1	10
OG0002414	1	0	1	6	1	1	10
OG0002415	4	0	4	2	0	0	10
OG0002416	1	1	1	6	0	1	10
OG0002417	2	0	0	7	0	1	10
OG0002418	5	1	1	1	1	1	10
OG0002419	2	0	1	5	1	1	10
OG0002420	1	1	1	6	0	1	10
OG0002421	2	0	1	5	1	1	10
OG0002422	1	1	2	4	1	1	10
OG0002423	2	0	0	7	0	1	10
OG0002424	1	0	1	8	0	0	10
OG0002425	1	1	2	4	1	1	10
OG0002426	1	0	1	8	0	0	10
OG0002427	2	0	2	4	1	1	10
OG0002428	2	1	1	4	1	1	10
OG0002429	1	0	0	9	0	0	10
OG0002430	3	0	1	4	1	1	10
OG0002431	2	1	1	4	1	1	10
OG0002432	2	1	1	4	1	1	10
OG0002433	1	0	1	6	1	1	10
OG0002434	1	0	1	6	1	1	10
OG0002435	2	1	1	4	1	1	10
OG0002436	2	1	4	2	0	1	10
OG0002437	2	0	0	8	0	0	10
OG0002438	3	0	1	4	1	1	10
OG0002439	1	1	1	5	1	1	10
OG0002440	2	1	1	4	1	1	10
OG0002441	1	0	0	8	0	1	10
OG0002442	2	0	1	6	0	1	10
OG0002443	1	0	1	6	1	1	10
OG0002444	1	1	6	0	1	1	10
OG0002445	1	0	1	6	1	1	10
OG0002446	2	0	4	2	1	1	10
OG0002447	2	1	1	4	1	1	10
OG0002448	2	0	1	5	1	1	10
OG0002449	1	0	1	6	1	1	10
OG0002450	2	1	2	4	0	1	10
OG0002451	3	0	1	5	0	1	10
OG0002452	0	1	2	6	0	1	10
OG0002453	0	2	3	0	2	3	10
OG0002454	0	1	1	6	1	1	10
OG0002455	0	2	1	4	1	2	10
OG0002456	0	2	6	0	1	1	10
OG0002457	0	1	1	6	1	1	10
OG0002458	0	2	2	2	2	2	10
OG0002459	0	1	1	6	1	1	10
OG0002460	0	1	1	6	1	1	10
OG0002461	0	1	2	4	1	2	10
OG0002462	0	1	1	6	1	1	10
OG0002463	0	2	0	8	0	0	10
OG0002464	0	0	10	0	0	0	10
OG0002465	0	0	9	0	1	0	10
OG0002466	0	0	2	8	0	0	10
OG0002467	0	0	1	9	0	0	10
OG0002468	0	0	1	8	0	1	10
OG0002469	0	0	2	7	0	1	10
OG0002470	0	0	1	7	1	1	10
OG0002471	0	0	2	7	0	1	10
OG0002472	0	0	2	8	0	0	10
OG0002473	0	0	0	10	0	0	10
OG0002474	0	0	0	10	0	0	10
OG0002475	0	0	0	10	0	0	10
OG0002476	0	0	0	9	1	0	10
OG0002477	0	0	0	10	0	0	10
OG0002478	0	0	0	8	1	1	10
OG0002479	0	0	0	10	0	0	10
OG0002480	0	0	0	10	0	0	10
OG0002481	1	1	1	4	1	1	9
OG0002482	2	1	2	2	1	1	9
OG0002483	1	1	1	4	1	1	9
OG0002484	1	0	0	8	0	0	9
OG0002485	3	1	1	2	1	1	9
OG0002486	3	1	1	2	1	1	9
OG0002487	3	1	2	2	0	1	9
OG0002488	3	1	1	2	1	1	9
OG0002489	1	1	1	4	1	1	9
OG0002490	2	0	1	4	1	1	9
OG0002491	1	1	3	2	1	1	9
OG0002492	2	0	1	4	1	1	9
OG0002493	3	1	1	2	1	1	9
OG0002494	3	1	1	4	0	0	9
OG0002495	4	0	1	2	1	1	9
OG0002496	4	0	1	2	1	1	9
OG0002497	8	0	1	0	0	0	9
OG0002498	3	1	1	2	1	1	9
OG0002499	4	0	3	0	1	1	9
OG0002500	1	1	2	4	0	1	9
OG0002501	4	0	1	2	1	1	9
OG0002502	2	1	1	4	0	1	9
OG0002503	2	0	1	4	1	1	9
OG0002504	1	1	1	4	1	1	9
OG0002505	3	1	1	2	1	1	9
OG0002506	4	0	4	0	0	1	9
OG0002507	2	0	1	4	1	1	9
OG0002508	4	0	1	2	1	1	9
OG0002509	3	0	0	4	1	1	9
OG0002510	1	1	1	4	1	1	9
OG0002511	2	0	1	4	1	1	9
OG0002512	3	0	2	4	0	0	9
OG0002513	2	0	1	6	0	0	9
OG0002514	2	0	1	4	1	1	9
OG0002515	1	1	1	4	1	1	9
OG0002516	1	0	0	8	0	0	9
OG0002517	1	1	0	6	1	0	9
OG0002518	2	1	2	2	1	1	9
OG0002519	2	0	1	4	1	1	9
OG0002520	1	1	1	4	1	1	9
OG0002521	2	0	0	6	0	1	9
OG0002522	1	1	1	4	1	1	9
OG0002523	2	1	1	4	0	1	9
OG0002524	3	0	1	3	1	1	9
OG0002525	1	1	1	4	1	1	9
OG0002526	3	1	1	2	1	1	9
OG0002527	6	0	0	0	1	2	9
OG0002528	2	2	2	2	0	1	9
OG0002529	2	1	1	3	1	1	9
OG0002530	2	0	1	4	1	1	9
OG0002531	4	0	1	2	1	1	9
OG0002532	4	0	1	2	1	1	9
OG0002533	3	0	0	6	0	0	9
OG0002534	3	1	1	2	1	1	9
OG0002535	1	1	1	4	1	1	9
OG0002536	3	0	2	2	1	1	9
OG0002537	3	0	1	4	0	1	9
OG0002538	3	1	1	2	1	1	9
OG0002539	1	1	1	4	1	1	9
OG0002540	1	0	0	8	0	0	9
OG0002541	2	0	1	4	0	2	9
OG0002542	2	1	1	4	0	1	9
OG0002543	6	0	1	0	1	1	9
OG0002544	4	0	1	4	0	0	9
OG0002545	2	0	0	6	1	0	9
OG0002546	1	0	0	8	0	0	9
OG0002547	2	0	1	6	0	0	9
OG0002548	2	1	1	3	1	1	9
OG0002549	3	1	1	2	1	1	9
OG0002550	2	1	2	2	1	1	9
OG0002551	2	0	0	7	0	0	9
OG0002552	3	1	1	2	1	1	9
OG0002553	1	1	0	5	2	0	9
OG0002554	3	1	1	2	1	1	9
OG0002555	1	0	1	5	1	1	9
OG0002556	2	0	1	4	1	1	9
OG0002557	4	0	1	2	1	1	9
OG0002558	3	1	1	2	1	1	9
OG0002559	1	1	1	4	1	1	9
OG0002560	2	0	1	4	1	1	9
OG0002561	1	1	1	4	1	1	9
OG0002562	2	0	1	4	1	1	9
OG0002563	2	1	0	4	1	1	9
OG0002564	2	0	6	0	0	1	9
OG0002565	6	0	0	3	0	0	9
OG0002566	4	1	0	2	1	1	9
OG0002567	8	0	1	0	0	0	9
OG0002568	3	1	1	2	1	1	9
OG0002569	8	0	0	0	1	0	9
OG0002570	5	0	3	0	0	1	9
OG0002571	7	0	0	2	0	0	9
OG0002572	5	0	2	0	1	1	9
OG0002573	2	0	1	4	1	1	9
OG0002574	3	0	1	4	0	1	9
OG0002575	2	0	1	4	1	1	9
OG0002576	5	0	1	1	1	1	9
OG0002577	2	0	0	7	0	0	9
OG0002578	2	0	2	4	1	0	9
OG0002579	2	0	0	6	0	1	9
OG0002580	3	0	1	4	0	1	9
OG0002581	2	0	1	4	1	1	9
OG0002582	3	1	1	2	1	1	9
OG0002583	2	1	1	2	2	1	9
OG0002584	4	0	1	4	0	0	9
OG0002585	1	0	0	8	0	0	9
OG0002586	4	0	1	2	1	1	9
OG0002587	5	0	1	2	0	1	9
OG0002588	1	1	1	4	1	1	9
OG0002589	2	0	0	7	0	0	9
OG0002590	3	0	1	3	1	1	9
OG0002591	7	0	0	2	0	0	9
OG0002592	2	1	1	3	1	1	9
OG0002593	3	0	1	4	1	0	9
OG0002594	5	0	0	4	0	0	9
OG0002595	5	0	4	0	0	0	9
OG0002596	2	0	0	7	0	0	9
OG0002597	1	0	1	6	0	1	9
OG0002598	3	1	1	2	1	1	9
OG0002599	3	1	1	2	1	1	9
OG0002600	2	0	1	6	0	0	9
OG0002601	5	1	1	0	1	1	9
OG0002602	3	0	1	4	0	1	9
OG0002603	4	0	2	2	0	1	9
OG0002604	3	1	2	1	1	1	9
OG0002605	2	0	0	6	1	0	9
OG0002606	6	0	1	2	0	0	9
OG0002607	5	0	0	2	1	1	9
OG0002608	7	0	0	2	0	0	9
OG0002609	6	0	1	0	1	1	9
OG0002610	4	0	2	1	1	1	9
OG0002611	4	1	1	2	1	0	9
OG0002612	3	1	1	2	1	1	9
OG0002613	5	1	1	0	1	1	9
OG0002614	2	0	0	6	1	0	9
OG0002615	6	0	0	2	0	1	9
OG0002616	5	0	0	4	0	0	9
OG0002617	2	0	1	4	1	1	9
OG0002618	7	0	0	0	1	1	9
OG0002619	3	0	2	0	4	0	9
OG0002620	2	0	1	4	1	1	9
OG0002621	1	1	1	4	1	1	9
OG0002622	2	1	2	2	1	1	9
OG0002623	2	0	1	4	1	1	9
OG0002624	2	0	2	4	1	0	9
OG0002625	3	1	1	2	1	1	9
OG0002626	1	0	0	8	0	0	9
OG0002627	1	1	1	4	1	1	9
OG0002628	1	0	0	8	0	0	9
OG0002629	1	0	0	8	0	0	9
OG0002630	1	2	4	0	2	0	9
OG0002631	1	1	1	4	1	1	9
OG0002632	3	1	1	2	1	1	9
OG0002633	1	0	3	2	1	2	9
OG0002634	1	0	1	6	0	1	9
OG0002635	2	0	1	4	1	1	9
OG0002636	1	0	0	8	0	0	9
OG0002637	1	1	1	4	0	2	9
OG0002638	5	1	1	0	1	1	9
OG0002639	1	1	1	4	1	1	9
OG0002640	2	2	2	0	1	2	9
OG0002641	4	1	2	0	1	1	9
OG0002642	1	0	0	8	0	0	9
OG0002643	1	1	1	4	1	1	9
OG0002644	3	0	3	2	0	1	9
OG0002645	2	1	2	2	1	1	9
OG0002646	1	1	1	4	1	1	9
OG0002647	1	1	1	4	0	2	9
OG0002648	2	1	2	2	1	1	9
OG0002649	2	1	1	3	1	1	9
OG0002650	2	1	4	0	1	1	9
OG0002651	2	0	1	6	0	0	9
OG0002652	3	1	3	2	0	0	9
OG0002653	3	1	0	4	0	1	9
OG0002654	1	1	1	4	1	1	9
OG0002655	4	0	2	2	0	1	9
OG0002656	4	0	1	2	1	1	9
OG0002657	2	1	1	3	1	1	9
OG0002658	1	0	0	8	0	0	9
OG0002659	1	1	1	5	0	1	9
OG0002660	1	0	1	5	1	1	9
OG0002661	3	1	1	2	1	1	9
OG0002662	1	1	1	4	1	1	9
OG0002663	3	1	1	2	1	1	9
OG0002664	1	1	1	4	1	1	9
OG0002665	3	1	1	2	1	1	9
OG0002666	1	1	1	4	1	1	9
OG0002667	2	1	1	3	1	1	9
OG0002668	1	0	0	8	0	0	9
OG0002669	4	1	2	0	1	1	9
OG0002670	3	1	1	4	0	0	9
OG0002671	1	1	1	4	1	1	9
OG0002672	3	1	1	2	1	1	9
OG0002673	2	1	2	2	1	1	9
OG0002674	1	0	1	7	0	0	9
OG0002675	2	1	1	3	1	1	9
OG0002676	3	0	2	0	2	2	9
OG0002677	3	0	0	4	0	2	9
OG0002678	1	0	0	8	0	0	9
OG0002679	1	0	2	4	1	1	9
OG0002680	2	1	0	4	1	1	9
OG0002681	1	0	0	6	1	1	9
OG0002682	2	0	0	7	0	0	9
OG0002683	2	1	2	2	1	1	9
OG0002684	1	0	0	8	0	0	9
OG0002685	4	0	1	3	0	1	9
OG0002686	1	1	1	4	1	1	9
OG0002687	2	1	2	2	1	1	9
OG0002688	3	1	1	2	1	1	9
OG0002689	1	0	0	6	1	1	9
OG0002690	1	0	1	5	1	1	9
OG0002691	2	1	2	3	0	1	9
OG0002692	3	1	1	2	1	1	9
OG0002693	1	0	0	8	0	0	9
OG0002694	1	0	1	6	0	1	9
OG0002695	1	1	1	4	1	1	9
OG0002696	1	1	3	1	1	2	9
OG0002697	2	0	1	4	1	1	9
OG0002698	1	1	1	4	1	1	9
OG0002699	4	0	3	2	0	0	9
OG0002700	1	0	0	8	0	0	9
OG0002701	2	1	2	2	1	1	9
OG0002702	1	1	2	4	1	0	9
OG0002703	2	0	1	4	1	1	9
OG0002704	1	1	1	4	1	1	9
OG0002705	1	0	2	4	1	1	9
OG0002706	3	0	0	6	0	0	9
OG0002707	2	1	1	3	1	1	9
OG0002708	1	0	1	6	0	1	9
OG0002709	3	0	2	4	0	0	9
OG0002710	1	1	0	7	0	0	9
OG0002711	1	1	1	4	1	1	9
OG0002712	2	0	4	0	1	2	9
OG0002713	2	2	1	2	1	1	9
OG0002714	2	1	1	4	0	1	9
OG0002715	4	0	1	2	1	1	9
OG0002716	2	0	1	4	1	1	9
OG0002717	2	1	0	2	1	3	9
OG0002718	1	0	2	4	1	1	9
OG0002719	3	1	0	2	1	2	9
OG0002720	2	1	0	4	1	1	9
OG0002721	2	0	1	4	1	1	9
OG0002722	2	0	2	4	1	0	9
OG0002723	1	1	1	4	1	1	9
OG0002724	2	1	0	4	1	1	9
OG0002725	1	0	1	6	0	1	9
OG0002726	2	1	1	4	0	1	9
OG0002727	1	0	2	4	1	1	9
OG0002728	2	0	1	4	1	1	9
OG0002729	1	0	1	6	0	1	9
OG0002730	2	1	1	2	2	1	9
OG0002731	1	1	1	4	1	1	9
OG0002732	1	1	1	4	1	1	9
OG0002733	1	1	1	4	1	1	9
OG0002734	1	1	1	4	1	1	9
OG0002735	1	0	1	6	0	1	9
OG0002736	3	0	1	4	0	1	9
OG0002737	3	0	3	2	0	1	9
OG0002738	1	1	1	4	1	1	9
OG0002739	1	1	1	3	2	1	9
OG0002740	1	0	2	4	1	1	9
OG0002741	1	0	1	6	0	1	9
OG0002742	1	1	2	3	1	1	9
OG0002743	2	0	1	4	1	1	9
OG0002744	1	1	2	4	0	1	9
OG0002745	1	0	0	8	0	0	9
OG0002746	2	1	1	4	0	1	9
OG0002747	1	0	1	2	2	3	9
OG0002748	3	1	1	2	1	1	9
OG0002749	2	0	0	6	0	1	9
OG0002750	1	1	1	4	1	1	9
OG0002751	1	1	1	4	1	1	9
OG0002752	2	0	1	4	1	1	9
OG0002753	2	1	0	6	0	0	9
OG0002754	4	0	1	2	1	1	9
OG0002755	1	1	4	2	0	1	9
OG0002756	1	1	1	4	1	1	9
OG0002757	2	0	1	5	1	0	9
OG0002758	2	0	1	6	0	0	9
OG0002759	2	0	0	6	1	0	9
OG0002760	3	0	1	3	1	1	9
OG0002761	1	0	0	8	0	0	9
OG0002762	1	2	1	4	1	0	9
OG0002763	4	0	1	4	0	0	9
OG0002764	2	0	1	4	0	2	9
OG0002765	3	0	1	3	1	1	9
OG0002766	3	0	1	3	1	1	9
OG0002767	4	1	1	2	1	0	9
OG0002768	0	1	5	2	1	0	9
OG0002769	0	1	1	5	1	1	9
OG0002770	0	2	7	0	0	0	9
OG0002771	0	1	0	6	1	1	9
OG0002772	0	1	2	4	1	1	9
OG0002773	0	1	2	4	1	1	9
OG0002774	0	1	2	4	1	1	9
OG0002775	0	3	5	1	0	0	9
OG0002776	0	1	2	5	0	1	9
OG0002777	0	1	0	6	1	1	9
OG0002778	0	1	0	6	1	1	9
OG0002779	0	0	8	0	1	0	9
OG0002780	0	0	1	6	1	1	9
OG0002781	0	0	1	6	1	1	9
OG0002782	0	0	7	0	1	1	9
OG0002783	0	0	8	0	0	1	9
OG0002784	0	0	3	4	1	1	9
OG0002785	0	0	1	6	1	1	9
OG0002786	0	0	2	4	1	2	9
OG0002787	0	0	8	0	1	0	9
OG0002788	0	0	1	6	1	1	9
OG0002789	0	0	1	6	1	1	9
OG0002790	0	0	1	7	0	1	9
OG0002791	0	0	1	7	0	1	9
OG0002792	0	0	2	2	2	3	9
OG0002793	0	0	1	6	1	1	9
OG0002794	0	0	1	6	1	1	9
OG0002795	0	0	1	7	0	1	9
OG0002796	0	0	1	8	0	0	9
OG0002797	0	0	1	6	1	1	9
OG0002798	0	0	0	8	0	1	9
OG0002799	0	0	0	9	0	0	9
OG0002800	2	1	1	2	1	1	8
OG0002801	2	1	1	2	1	1	8
OG0002802	1	0	1	4	1	1	8
OG0002803	4	0	0	2	1	1	8
OG0002804	4	0	0	2	1	1	8
OG0002805	1	0	1	4	1	1	8
OG0002806	5	0	1	0	1	1	8
OG0002807	2	0	0	6	0	0	8
OG0002808	2	0	0	6	0	0	8
OG0002809	2	0	1	4	1	0	8
OG0002810	2	1	1	2	1	1	8
OG0002811	4	0	3	0	0	1	8
OG0002812	2	0	1	4	0	1	8
OG0002813	6	0	1	0	1	0	8
OG0002814	2	0	0	4	1	1	8
OG0002815	3	1	4	0	0	0	8
OG0002816	2	1	2	2	0	1	8
OG0002817	3	0	1	2	1	1	8
OG0002818	2	1	1	2	1	1	8
OG0002819	4	0	1	2	0	1	8
OG0002820	1	0	1	6	0	0	8
OG0002821	2	0	2	2	1	1	8
OG0002822	4	0	2	0	1	1	8
OG0002823	6	0	0	2	0	0	8
OG0002824	4	0	1	2	0	1	8
OG0002825	4	0	1	2	0	1	8
OG0002826	1	0	2	4	0	1	8
OG0002827	1	1	0	4	1	1	8
OG0002828	1	0	5	0	1	1	8
OG0002829	2	1	1	2	1	1	8
OG0002830	1	0	1	5	1	0	8
OG0002831	1	0	2	4	0	1	8
OG0002832	2	1	1	2	1	1	8
OG0002833	3	0	1	2	1	1	8
OG0002834	3	0	2	1	1	1	8
OG0002835	1	1	1	3	1	1	8
OG0002836	2	0	0	6	0	0	8
OG0002837	2	1	1	2	1	1	8
OG0002838	2	0	1	5	0	0	8
OG0002839	3	0	1	2	1	1	8
OG0002840	6	0	0	2	0	0	8
OG0002841	2	0	1	4	1	0	8
OG0002842	1	1	0	4	1	1	8
OG0002843	1	1	1	3	1	1	8
OG0002844	1	0	3	2	1	1	8
OG0002845	1	0	1	4	0	2	8
OG0002846	2	1	1	2	1	1	8
OG0002847	4	1	1	1	0	1	8
OG0002848	2	1	1	2	1	1	8
OG0002849	2	1	1	2	1	1	8
OG0002850	1	1	0	4	1	1	8
OG0002851	4	1	1	0	1	1	8
OG0002852	3	1	2	0	1	1	8
OG0002853	3	0	1	2	1	1	8
OG0002854	6	0	0	0	1	1	8
OG0002855	5	0	0	2	0	1	8
OG0002856	8	0	0	0	0	0	8
OG0002857	1	0	0	6	0	1	8
OG0002858	2	1	1	2	1	1	8
OG0002859	4	1	1	0	1	1	8
OG0002860	3	0	1	4	0	0	8
OG0002861	1	0	1	4	1	1	8
OG0002862	1	0	1	4	1	1	8
OG0002863	2	0	0	4	1	1	8
OG0002864	3	0	1	3	1	0	8
OG0002865	6	0	0	2	0	0	8
OG0002866	6	0	0	2	0	0	8
OG0002867	2	1	1	2	1	1	8
OG0002868	5	0	1	2	0	0	8
OG0002869	2	1	1	2	1	1	8
OG0002870	2	0	1	3	1	1	8
OG0002871	2	0	0	5	1	0	8
OG0002872	4	0	1	2	0	1	8
OG0002873	3	0	3	0	1	1	8
OG0002874	2	0	2	2	1	1	8
OG0002875	1	1	1	3	1	1	8
OG0002876	4	0	1	2	1	0	8
OG0002877	6	0	0	2	0	0	8
OG0002878	1	0	2	4	0	1	8
OG0002879	3	1	1	2	1	0	8
OG0002880	2	0	0	4	1	1	8
OG0002881	2	1	1	2	1	1	8
OG0002882	3	0	1	4	0	0	8
OG0002883	2	1	1	4	0	0	8
OG0002884	2	0	1	4	0	1	8
OG0002885	2	0	1	4	0	1	8
OG0002886	2	1	1	2	1	1	8
OG0002887	2	0	1	3	1	1	8
OG0002888	2	0	1	3	1	1	8
OG0002889	4	0	0	4	0	0	8
OG0002890	4	0	1	2	0	1	8
OG0002891	2	0	1	4	1	0	8
OG0002892	6	0	0	2	0	0	8
OG0002893	2	1	1	2	1	1	8
OG0002894	3	0	1	2	1	1	8
OG0002895	2	0	1	4	1	0	8
OG0002896	1	0	1	4	1	1	8
OG0002897	1	0	0	6	0	1	8
OG0002898	2	1	1	2	1	1	8
OG0002899	6	0	0	2	0	0	8
OG0002900	1	0	1	2	2	2	8
OG0002901	2	0	0	6	0	0	8
OG0002902	4	0	2	0	1	1	8
OG0002903	3	0	1	2	1	1	8
OG0002904	4	1	0	2	0	1	8
OG0002905	8	0	0	0	0	0	8
OG0002906	2	0	2	2	1	1	8
OG0002907	2	0	2	2	1	1	8
OG0002908	2	1	0	4	0	1	8
OG0002909	2	0	0	6	0	0	8
OG0002910	2	0	0	6	0	0	8
OG0002911	3	0	1	4	0	0	8
OG0002912	5	0	1	0	1	1	8
OG0002913	1	0	3	2	1	1	8
OG0002914	1	0	1	4	1	1	8
OG0002915	4	0	1	3	0	0	8
OG0002916	2	0	0	6	0	0	8
OG0002917	2	0	0	6	0	0	8
OG0002918	2	1	1	2	1	1	8
OG0002919	5	1	0	0	1	1	8
OG0002920	2	1	1	2	1	1	8
OG0002921	2	1	1	2	1	1	8
OG0002922	5	0	1	0	1	1	8
OG0002923	4	0	0	4	0	0	8
OG0002924	5	1	0	2	0	0	8
OG0002925	4	0	0	4	0	0	8
OG0002926	4	1	1	0	1	1	8
OG0002927	4	0	0	4	0	0	8
OG0002928	4	0	0	2	1	1	8
OG0002929	4	0	1	3	0	0	8
OG0002930	2	0	1	4	0	1	8
OG0002931	7	0	1	0	0	0	8
OG0002932	6	0	1	0	0	1	8
OG0002933	1	0	0	7	0	0	8
OG0002934	5	1	1	0	0	1	8
OG0002935	2	0	1	4	0	1	8
OG0002936	1	0	0	7	0	0	8
OG0002937	1	0	0	6	0	1	8
OG0002938	3	0	1	2	1	1	8
OG0002939	8	0	0	0	0	0	8
OG0002940	2	0	0	6	0	0	8
OG0002941	2	0	2	3	0	1	8
OG0002942	4	0	2	2	0	0	8
OG0002943	3	0	1	4	0	0	8
OG0002944	6	0	2	0	0	0	8
OG0002945	2	0	0	6	0	0	8
OG0002946	3	0	2	2	0	1	8
OG0002947	1	0	1	6	0	0	8
OG0002948	4	1	1	0	0	2	8
OG0002949	4	0	0	4	0	0	8
OG0002950	7	0	0	0	1	0	8
OG0002951	1	0	1	4	1	1	8
OG0002952	2	1	1	2	1	1	8
OG0002953	1	0	0	7	0	0	8
OG0002954	6	0	1	0	0	1	8
OG0002955	2	0	1	3	1	1	8
OG0002956	1	0	0	6	0	1	8
OG0002957	1	0	0	6	1	0	8
OG0002958	1	0	3	2	1	1	8
OG0002959	3	0	1	4	0	0	8
OG0002960	1	1	0	4	1	1	8
OG0002961	1	1	0	4	0	2	8
OG0002962	3	2	1	2	0	0	8
OG0002963	2	1	1	2	1	1	8
OG0002964	1	0	0	7	0	0	8
OG0002965	1	1	1	4	0	1	8
OG0002966	1	0	0	7	0	0	8
OG0002967	1	1	0	4	1	1	8
OG0002968	1	0	2	3	1	1	8
OG0002969	2	1	1	2	1	1	8
OG0002970	3	1	1	2	0	1	8
OG0002971	1	0	1	4	1	1	8
OG0002972	2	0	0	6	0	0	8
OG0002973	1	0	0	7	0	0	8
OG0002974	2	0	1	2	1	2	8
OG0002975	1	0	2	4	0	1	8
OG0002976	3	0	0	2	2	1	8
OG0002977	1	0	0	7	0	0	8
OG0002978	2	0	2	2	1	1	8
OG0002979	2	0	0	4	1	1	8
OG0002980	1	0	1	6	0	0	8
OG0002981	1	0	0	7	0	0	8
OG0002982	1	0	1	4	1	1	8
OG0002983	1	1	1	4	0	1	8
OG0002984	2	0	1	5	0	0	8
OG0002985	3	0	1	2	1	1	8
OG0002986	1	0	1	4	1	1	8
OG0002987	2	1	1	2	1	1	8
OG0002988	1	0	0	7	0	0	8
OG0002989	1	0	0	6	1	0	8
OG0002990	1	0	0	7	0	0	8
OG0002991	3	0	3	0	0	2	8
OG0002992	2	0	2	2	1	1	8
OG0002993	4	0	2	2	0	0	8
OG0002994	1	1	2	2	1	1	8
OG0002995	1	1	1	3	1	1	8
OG0002996	1	1	0	4	1	1	8
OG0002997	4	0	0	2	1	1	8
OG0002998	1	1	0	4	1	1	8
OG0002999	4	1	1	0	1	1	8
OG0003000	2	0	0	6	0	0	8
OG0003001	2	1	1	2	1	1	8
OG0003002	1	0	1	4	1	1	8
OG0003003	1	0	1	6	0	0	8
OG0003004	1	1	2	4	0	0	8
OG0003005	1	0	1	4	1	1	8
OG0003006	1	1	1	2	1	2	8
OG0003007	2	0	3	2	0	1	8
OG0003008	2	1	1	2	1	1	8
OG0003009	2	0	0	6	0	0	8
OG0003010	1	1	1	4	0	1	8
OG0003011	1	0	1	4	1	1	8
OG0003012	2	1	1	2	1	1	8
OG0003013	1	0	1	4	1	1	8
OG0003014	1	0	1	6	0	0	8
OG0003015	2	1	0	4	0	1	8
OG0003016	1	0	2	4	0	1	8
OG0003017	1	1	0	4	1	1	8
OG0003018	2	1	1	2	1	1	8
OG0003019	2	1	1	2	1	1	8
OG0003020	2	1	1	2	1	1	8
OG0003021	1	0	1	6	0	0	8
OG0003022	1	0	1	4	1	1	8
OG0003023	2	0	0	4	1	1	8
OG0003024	1	0	4	2	1	0	8
OG0003025	1	1	1	4	0	1	8
OG0003026	1	0	1	4	1	1	8
OG0003027	1	0	1	4	1	1	8
OG0003028	1	0	0	7	0	0	8
OG0003029	2	1	1	2	1	1	8
OG0003030	3	0	4	0	0	1	8
OG0003031	2	1	1	2	1	1	8
OG0003032	1	0	0	6	1	0	8
OG0003033	3	0	0	3	2	0	8
OG0003034	1	0	1	4	1	1	8
OG0003035	2	1	1	2	1	1	8
OG0003036	1	1	1	3	1	1	8
OG0003037	1	0	1	4	1	1	8
OG0003038	1	0	1	4	1	1	8
OG0003039	1	0	1	4	1	1	8
OG0003040	2	0	3	2	0	1	8
OG0003041	3	1	0	2	1	1	8
OG0003042	3	0	4	0	0	1	8
OG0003043	1	0	1	4	1	1	8
OG0003044	2	0	1	4	1	0	8
OG0003045	2	1	1	2	1	1	8
OG0003046	5	0	2	0	0	1	8
OG0003047	2	0	0	6	0	0	8
OG0003048	1	1	2	2	1	1	8
OG0003049	1	0	1	4	1	1	8
OG0003050	1	0	1	4	1	1	8
OG0003051	1	1	1	3	1	1	8
OG0003052	1	0	1	4	1	1	8
OG0003053	4	0	1	2	0	1	8
OG0003054	2	0	0	6	0	0	8
OG0003055	1	0	1	5	0	1	8
OG0003056	1	0	1	6	0	0	8
OG0003057	1	1	1	4	0	1	8
OG0003058	3	0	0	4	1	0	8
OG0003059	1	0	1	4	1	1	8
OG0003060	1	1	2	2	1	1	8
OG0003061	1	0	0	7	0	0	8
OG0003062	1	0	0	7	0	0	8
OG0003063	1	0	1	4	1	1	8
OG0003064	4	1	2	0	1	0	8
OG0003065	3	0	1	2	1	1	8
OG0003066	2	0	3	0	1	2	8
OG0003067	1	0	1	4	1	1	8
OG0003068	1	0	1	4	1	1	8
OG0003069	1	0	1	4	1	1	8
OG0003070	1	0	0	4	2	1	8
OG0003071	3	0	1	2	1	1	8
OG0003072	1	0	1	4	1	1	8
OG0003073	1	0	0	3	2	2	8
OG0003074	1	0	1	4	1	1	8
OG0003075	1	0	0	7	0	0	8
OG0003076	1	0	0	7	0	0	8
OG0003077	2	1	1	2	1	1	8
OG0003078	3	1	0	2	1	1	8
OG0003079	2	1	1	2	1	1	8
OG0003080	2	0	0	5	0	1	8
OG0003081	2	1	1	2	1	1	8
OG0003082	4	1	1	0	1	1	8
OG0003083	0	1	6	0	0	1	8
OG0003084	0	1	0	7	0	0	8
OG0003085	0	2	1	4	1	0	8
OG0003086	0	1	1	4	1	1	8
OG0003087	0	1	1	4	1	1	8
OG0003088	0	1	1	4	1	1	8
OG0003089	0	1	1	4	1	1	8
OG0003090	0	1	0	6	1	0	8
OG0003091	0	1	1	4	1	1	8
OG0003092	0	2	0	5	0	1	8
OG0003093	0	1	1	4	1	1	8
OG0003094	0	1	1	4	1	1	8
OG0003095	0	1	5	0	1	1	8
OG0003096	0	1	0	0	0	7	8
OG0003097	0	1	1	4	1	1	8
OG0003098	0	1	2	2	2	1	8
OG0003099	0	1	1	4	1	1	8
OG0003100	0	1	1	4	1	1	8
OG0003101	0	1	1	4	1	1	8
OG0003102	0	2	1	4	0	1	8
OG0003103	0	1	2	4	0	1	8
OG0003104	0	1	1	4	1	1	8
OG0003105	0	2	6	0	0	0	8
OG0003106	0	1	1	4	1	1	8
OG0003107	0	1	1	4	1	1	8
OG0003108	0	1	6	0	1	0	8
OG0003109	0	0	8	0	0	0	8
OG0003110	0	0	8	0	0	0	8
OG0003111	0	0	2	3	2	1	8
OG0003112	0	0	1	6	0	1	8
OG0003113	0	0	2	6	0	0	8
OG0003114	0	0	1	5	1	1	8
OG0003115	0	0	2	3	2	1	8
OG0003116	0	0	2	6	0	0	8
OG0003117	0	0	2	6	0	0	8
OG0003118	0	0	1	7	0	0	8
OG0003119	0	0	0	6	1	1	8
OG0003120	0	0	0	6	1	1	8
OG0003121	0	0	0	6	1	1	8
OG0003122	0	0	0	6	1	1	8
OG0003123	0	0	0	6	1	1	8
OG0003124	0	0	0	8	0	0	8
OG0003125	0	0	0	8	0	0	8
OG0003126	0	0	0	6	1	1	8
OG0003127	0	0	0	6	1	1	8
OG0003128	0	0	0	8	0	0	8
OG0003129	0	0	0	7	0	1	8
OG0003130	2	0	1	2	1	1	7
OG0003131	3	0	0	2	1	1	7
OG0003132	5	0	0	2	0	0	7
OG0003133	1	0	1	5	0	0	7
OG0003134	1	0	2	2	1	1	7
OG0003135	5	0	1	0	0	1	7
OG0003136	2	0	1	2	1	1	7
OG0003137	3	0	1	1	1	1	7
OG0003138	1	0	1	3	1	1	7
OG0003139	1	1	1	2	1	1	7
OG0003140	1	0	0	5	0	1	7
OG0003141	2	0	1	2	1	1	7
OG0003142	3	0	0	3	0	1	7
OG0003143	5	1	0	0	1	0	7
OG0003144	3	0	0	4	0	0	7
OG0003145	4	0	0	2	0	1	7
OG0003146	3	1	0	2	0	1	7
OG0003147	1	1	3	2	0	0	7
OG0003148	2	0	0	5	0	0	7
OG0003149	2	0	0	4	0	1	7
OG0003150	1	0	1	4	0	1	7
OG0003151	3	0	2	0	1	1	7
OG0003152	2	0	1	4	0	0	7
OG0003153	1	0	0	4	1	1	7
OG0003154	2	0	4	0	0	1	7
OG0003155	2	0	1	4	0	0	7
OG0003156	1	1	1	2	1	1	7
OG0003157	1	1	1	2	1	1	7
OG0003158	2	0	1	2	1	1	7
OG0003159	2	1	0	4	0	0	7
OG0003160	1	0	0	6	0	0	7
OG0003161	1	1	1	2	1	1	7
OG0003162	1	1	1	2	1	1	7
OG0003163	3	0	1	2	0	1	7
OG0003164	1	0	1	4	0	1	7
OG0003165	1	0	0	6	0	0	7
OG0003166	1	0	1	3	1	1	7
OG0003167	2	0	0	5	0	0	7
OG0003168	1	0	0	6	0	0	7
OG0003169	1	1	1	2	1	1	7
OG0003170	1	0	1	5	0	0	7
OG0003171	1	0	0	6	0	0	7
OG0003172	3	0	1	2	0	1	7
OG0003173	1	1	1	2	1	1	7
OG0003174	3	0	1	2	0	1	7
OG0003175	1	0	0	4	1	1	7
OG0003176	2	0	1	3	0	1	7
OG0003177	1	0	1	3	1	1	7
OG0003178	1	1	1	2	1	1	7
OG0003179	2	0	1	2	1	1	7
OG0003180	2	0	1	2	1	1	7
OG0003181	3	0	1	2	0	1	7
OG0003182	1	0	0	6	0	0	7
OG0003183	2	1	2	2	0	0	7
OG0003184	3	0	0	2	1	1	7
OG0003185	3	1	1	0	1	1	7
OG0003186	1	1	1	2	1	1	7
OG0003187	2	0	1	3	0	1	7
OG0003188	1	0	0	6	0	0	7
OG0003189	1	0	0	6	0	0	7
OG0003190	2	1	1	2	0	1	7
OG0003191	4	1	0	0	1	1	7
OG0003192	3	0	2	2	0	0	7
OG0003193	2	1	1	1	1	1	7
OG0003194	2	0	1	4	0	0	7
OG0003195	5	0	1	0	0	1	7
OG0003196	2	0	2	0	2	1	7
OG0003197	4	0	0	3	0	0	7
OG0003198	4	0	2	0	1	0	7
OG0003199	3	0	2	0	1	1	7
OG0003200	2	0	1	2	1	1	7
OG0003201	4	0	2	0	0	1	7
OG0003202	1	0	0	6	0	0	7
OG0003203	1	1	1	2	1	1	7
OG0003204	1	0	0	6	0	0	7
OG0003205	1	0	0	6	0	0	7
OG0003206	2	0	2	3	0	0	7
OG0003207	1	0	0	4	1	1	7
OG0003208	4	0	1	0	1	1	7
OG0003209	1	0	0	6	0	0	7
OG0003210	3	1	1	0	1	1	7
OG0003211	2	0	1	2	1	1	7
OG0003212	2	0	2	2	0	1	7
OG0003213	2	0	1	2	1	1	7
OG0003214	1	0	1	4	1	0	7
OG0003215	1	0	1	5	0	0	7
OG0003216	1	0	0	6	0	0	7
OG0003217	1	0	0	6	0	0	7
OG0003218	3	1	1	0	1	1	7
OG0003219	3	0	0	4	0	0	7
OG0003220	2	0	0	2	2	1	7
OG0003221	3	0	0	4	0	0	7
OG0003222	6	0	1	0	0	0	7
OG0003223	4	1	1	0	0	1	7
OG0003224	3	0	0	4	0	0	7
OG0003225	2	1	4	0	0	0	7
OG0003226	4	0	0	2	0	1	7
OG0003227	3	1	1	1	0	1	7
OG0003228	1	0	1	5	0	0	7
OG0003229	1	0	0	6	0	0	7
OG0003230	2	0	0	0	0	5	7
OG0003231	3	0	0	4	0	0	7
OG0003232	3	0	2	0	0	2	7
OG0003233	3	0	0	4	0	0	7
OG0003234	2	1	1	3	0	0	7
OG0003235	1	0	0	6	0	0	7
OG0003236	5	0	0	2	0	0	7
OG0003237	2	1	1	2	0	1	7
OG0003238	2	0	1	3	0	1	7
OG0003239	1	0	2	2	1	1	7
OG0003240	1	1	1	2	1	1	7
OG0003241	3	0	0	4	0	0	7
OG0003242	2	1	1	1	1	1	7
OG0003243	1	0	0	6	0	0	7
OG0003244	3	0	4	0	0	0	7
OG0003245	3	1	1	0	1	1	7
OG0003246	1	0	0	4	1	1	7
OG0003247	1	0	0	6	0	0	7
OG0003248	2	0	0	5	0	0	7
OG0003249	4	0	0	2	0	1	7
OG0003250	5	0	0	2	0	0	7
OG0003251	3	0	0	4	0	0	7
OG0003252	2	1	1	1	1	1	7
OG0003253	4	0	1	0	1	1	7
OG0003254	5	0	0	0	1	1	7
OG0003255	4	0	1	2	0	0	7
OG0003256	1	0	0	5	0	1	7
OG0003257	1	0	0	6	0	0	7
OG0003258	3	0	0	4	0	0	7
OG0003259	3	1	1	0	1	1	7
OG0003260	2	1	0	2	1	1	7
OG0003261	2	0	0	4	0	1	7
OG0003262	1	0	0	6	0	0	7
OG0003263	1	0	0	6	0	0	7
OG0003264	1	0	0	6	0	0	7
OG0003265	2	1	0	2	1	1	7
OG0003266	2	1	1	2	0	1	7
OG0003267	1	0	0	6	0	0	7
OG0003268	1	0	0	6	0	0	7
OG0003269	1	1	1	2	1	1	7
OG0003270	1	1	1	2	1	1	7
OG0003271	1	0	2	3	0	1	7
OG0003272	1	0	1	4	0	1	7
OG0003273	1	0	0	6	0	0	7
OG0003274	2	1	3	0	0	1	7
OG0003275	2	2	0	2	1	0	7
OG0003276	2	1	2	0	1	1	7
OG0003277	1	0	0	6	0	0	7
OG0003278	2	0	1	2	1	1	7
OG0003279	3	0	1	0	2	1	7
OG0003280	3	1	2	0	0	1	7
OG0003281	2	0	1	2	1	1	7
OG0003282	1	0	0	5	0	1	7
OG0003283	1	0	0	6	0	0	7
OG0003284	1	1	0	4	0	1	7
OG0003285	1	0	0	6	0	0	7
OG0003286	1	1	1	2	1	1	7
OG0003287	1	0	0	6	0	0	7
OG0003288	1	0	0	6	0	0	7
OG0003289	1	0	0	6	0	0	7
OG0003290	1	1	1	2	1	1	7
OG0003291	1	0	0	6	0	0	7
OG0003292	2	1	2	1	0	1	7
OG0003293	2	0	0	4	0	1	7
OG0003294	1	1	1	2	1	1	7
OG0003295	3	0	2	0	1	1	7
OG0003296	4	1	0	0	1	1	7
OG0003297	3	0	0	2	1	1	7
OG0003298	1	1	1	2	1	1	7
OG0003299	1	0	1	4	0	1	7
OG0003300	1	0	0	6	0	0	7
OG0003301	1	0	0	6	0	0	7
OG0003302	1	0	0	6	0	0	7
OG0003303	1	2	4	0	0	0	7
OG0003304	1	1	0	4	0	1	7
OG0003305	2	1	2	0	1	1	7
OG0003306	1	1	2	2	0	1	7
OG0003307	1	0	0	6	0	0	7
OG0003308	1	1	1	2	1	1	7
OG0003309	1	0	3	2	1	0	7
OG0003310	2	0	1	4	0	0	7
OG0003311	1	0	0	6	0	0	7
OG0003312	1	1	1	2	1	1	7
OG0003313	1	0	2	2	1	1	7
OG0003314	1	0	1	4	0	1	7
OG0003315	3	1	1	0	1	1	7
OG0003316	1	2	3	0	0	1	7
OG0003317	1	0	1	4	0	1	7
OG0003318	2	0	0	4	0	1	7
OG0003319	1	1	1	2	1	1	7
OG0003320	2	1	1	0	1	2	7
OG0003321	2	0	1	2	1	1	7
OG0003322	1	0	0	6	0	0	7
OG0003323	1	0	4	0	0	2	7
OG0003324	2	1	2	2	0	0	7
OG0003325	1	1	1	2	1	1	7
OG0003326	1	1	0	3	1	1	7
OG0003327	2	1	1	2	1	0	7
OG0003328	2	1	0	2	1	1	7
OG0003329	1	0	0	6	0	0	7
OG0003330	2	0	1	2	1	1	7
OG0003331	1	1	1	2	1	1	7
OG0003332	1	0	5	0	0	1	7
OG0003333	2	1	2	0	1	1	7
OG0003334	1	1	1	2	1	1	7
OG0003335	1	0	1	5	0	0	7
OG0003336	2	1	0	2	1	1	7
OG0003337	1	0	1	4	0	1	7
OG0003338	2	1	1	2	0	1	7
OG0003339	3	1	1	0	1	1	7
OG0003340	1	0	0	6	0	0	7
OG0003341	1	1	1	2	1	1	7
OG0003342	1	0	1	4	0	1	7
OG0003343	2	1	2	0	1	1	7
OG0003344	1	0	0	6	0	0	7
OG0003345	1	0	0	6	0	0	7
OG0003346	2	0	0	5	0	0	7
OG0003347	2	1	1	0	2	1	7
OG0003348	2	0	0	3	1	1	7
OG0003349	2	0	0	4	0	1	7
OG0003350	1	0	0	6	0	0	7
OG0003351	1	0	1	2	1	2	7
OG0003352	4	0	1	0	1	1	7
OG0003353	3	1	1	0	1	1	7
OG0003354	1	1	1	2	1	1	7
OG0003355	1	0	5	0	0	1	7
OG0003356	1	1	1	2	1	1	7
OG0003357	1	0	0	6	0	0	7
OG0003358	2	0	1	2	1	1	7
OG0003359	2	0	1	2	1	1	7
OG0003360	1	0	0	6	0	0	7
OG0003361	1	0	1	3	1	1	7
OG0003362	1	0	0	6	0	0	7
OG0003363	2	0	0	4	0	1	7
OG0003364	1	0	0	4	1	1	7
OG0003365	2	0	1	2	1	1	7
OG0003366	2	0	1	4	0	0	7
OG0003367	3	0	1	1	1	1	7
OG0003368	1	0	0	6	0	0	7
OG0003369	2	1	1	2	0	1	7
OG0003370	2	0	1	2	1	1	7
OG0003371	1	1	1	2	1	1	7
OG0003372	1	1	1	2	1	1	7
OG0003373	3	1	1	0	1	1	7
OG0003374	2	1	1	1	1	1	7
OG0003375	1	0	0	6	0	0	7
OG0003376	2	0	1	4	0	0	7
OG0003377	1	0	0	6	0	0	7
OG0003378	1	0	1	3	1	1	7
OG0003379	1	0	0	6	0	0	7
OG0003380	1	0	1	3	1	1	7
OG0003381	1	1	1	0	3	1	7
OG0003382	2	1	1	2	0	1	7
OG0003383	2	1	2	0	1	1	7
OG0003384	5	0	1	0	0	1	7
OG0003385	2	0	1	4	0	0	7
OG0003386	2	0	1	2	1	1	7
OG0003387	1	0	0	4	1	1	7
OG0003388	2	0	1	2	1	1	7
OG0003389	1	1	1	2	1	1	7
OG0003390	2	0	1	2	1	1	7
OG0003391	2	1	0	2	1	1	7
OG0003392	1	1	3	0	1	1	7
OG0003393	4	0	1	2	0	0	7
OG0003394	2	0	1	4	0	0	7
OG0003395	1	0	0	6	0	0	7
OG0003396	1	1	0	3	1	1	7
OG0003397	1	0	1	3	1	1	7
OG0003398	3	0	0	4	0	0	7
OG0003399	2	0	1	2	1	1	7
OG0003400	2	1	1	2	0	1	7
OG0003401	1	0	0	6	0	0	7
OG0003402	2	1	1	0	2	1	7
OG0003403	1	0	1	3	1	1	7
OG0003404	3	1	1	0	1	1	7
OG0003405	2	0	1	4	0	0	7
OG0003406	2	1	1	2	0	1	7
OG0003407	3	1	0	2	1	0	7
OG0003408	3	0	1	2	0	1	7
OG0003409	3	0	1	2	0	1	7
OG0003410	1	0	1	5	0	0	7
OG0003411	1	1	1	2	1	1	7
OG0003412	1	0	2	2	1	1	7
OG0003413	2	0	1	2	1	1	7
OG0003414	3	1	1	0	1	1	7
OG0003415	7	0	0	0	0	0	7
OG0003416	6	0	0	0	0	1	7
OG0003417	5	0	0	0	1	1	7
OG0003418	1	1	1	2	1	1	7
OG0003419	2	1	1	2	0	1	7
OG0003420	1	0	2	2	1	1	7
OG0003421	2	0	1	2	1	1	7
OG0003422	1	1	1	4	0	0	7
OG0003423	1	1	1	3	0	1	7
OG0003424	2	0	1	4	0	0	7
OG0003425	2	1	1	2	1	0	7
OG0003426	3	0	1	2	0	1	7
OG0003427	4	1	1	0	0	1	7
OG0003428	1	0	1	3	1	1	7
OG0003429	1	1	1	4	0	0	7
OG0003430	2	0	1	2	1	1	7
OG0003431	1	1	1	2	1	1	7
OG0003432	1	0	0	6	0	0	7
OG0003433	1	0	1	3	1	1	7
OG0003434	1	0	0	6	0	0	7
OG0003435	0	1	1	3	1	1	7
OG0003436	0	1	0	4	1	1	7
OG0003437	0	1	1	3	1	1	7
OG0003438	0	1	0	6	0	0	7
OG0003439	0	1	1	2	1	2	7
OG0003440	0	1	0	2	2	2	7
OG0003441	0	2	2	0	2	1	7
OG0003442	0	1	1	4	0	1	7
OG0003443	0	1	0	4	1	1	7
OG0003444	0	1	2	2	1	1	7
OG0003445	0	1	2	0	2	2	7
OG0003446	0	1	2	0	2	2	7
OG0003447	0	1	6	0	0	0	7
OG0003448	0	1	5	0	1	0	7
OG0003449	0	1	1	4	0	1	7
OG0003450	0	0	5	0	1	1	7
OG0003451	0	0	1	4	1	1	7
OG0003452	0	0	2	2	1	2	7
OG0003453	0	0	1	4	1	1	7
OG0003454	0	0	1	4	1	1	7
OG0003455	0	0	2	4	0	1	7
OG0003456	0	0	7	0	0	0	7
OG0003457	0	0	1	4	1	1	7
OG0003458	0	0	1	4	1	1	7
OG0003459	0	0	6	0	0	1	7
OG0003460	0	0	1	4	1	1	7
OG0003461	0	0	1	4	1	1	7
OG0003462	0	0	1	4	1	1	7
OG0003463	0	0	1	4	1	1	7
OG0003464	0	0	2	0	2	3	7
OG0003465	0	0	3	4	0	0	7
OG0003466	0	0	1	4	1	1	7
OG0003467	0	0	1	6	0	0	7
OG0003468	0	0	3	2	1	1	7
OG0003469	0	0	5	0	0	2	7
OG0003470	0	0	1	2	2	2	7
OG0003471	0	0	1	4	1	1	7
OG0003472	0	0	2	3	1	1	7
OG0003473	0	0	1	4	1	1	7
OG0003474	0	0	4	0	2	1	7
OG0003475	0	0	1	6	0	0	7
OG0003476	0	0	1	4	1	1	7
OG0003477	0	0	0	7	0	0	7
OG0003478	0	0	0	4	1	2	7
OG0003479	0	0	0	7	0	0	7
OG0003480	0	0	0	5	1	1	7
OG0003481	0	0	0	6	1	0	7
OG0003482	0	0	0	5	1	1	7
OG0003483	0	0	0	6	0	1	7
OG0003484	0	0	0	6	1	0	7
OG0003485	0	0	0	7	0	0	7
OG0003486	2	1	1	0	1	1	6
OG0003487	2	1	1	0	1	1	6
OG0003488	1	0	0	3	1	1	6
OG0003489	1	0	1	4	0	0	6
OG0003490	1	1	0	2	1	1	6
OG0003491	3	0	2	0	0	1	6
OG0003492	1	0	1	4	0	0	6
OG0003493	1	1	1	1	1	1	6
OG0003494	3	0	1	0	1	1	6
OG0003495	2	1	1	0	1	1	6
OG0003496	2	0	1	2	0	1	6
OG0003497	2	1	1	0	1	1	6
OG0003498	2	0	1	2	0	1	6
OG0003499	3	0	1	0	1	1	6
OG0003500	4	1	0	0	0	1	6
OG0003501	1	0	1	2	1	1	6
OG0003502	1	0	1	2	1	1	6
OG0003503	2	1	1	0	1	1	6
OG0003504	3	0	2	0	1	0	6
OG0003505	3	1	1	0	0	1	6
OG0003506	3	1	1	0	0	1	6
OG0003507	2	1	1	0	1	1	6
OG0003508	3	1	0	0	1	1	6
OG0003509	1	0	1	2	1	1	6
OG0003510	2	0	1	2	0	1	6
OG0003511	1	1	1	2	0	1	6
OG0003512	1	0	1	2	1	1	6
OG0003513	1	0	1	2	1	1	6
OG0003514	1	1	1	1	1	1	6
OG0003515	1	0	0	4	0	1	6
OG0003516	3	0	2	0	0	1	6
OG0003517	1	1	0	2	1	1	6
OG0003518	1	0	0	5	0	0	6
OG0003519	1	1	1	1	1	1	6
OG0003520	3	0	1	0	1	1	6
OG0003521	1	0	1	2	1	1	6
OG0003522	2	0	2	0	1	1	6
OG0003523	3	1	1	0	0	1	6
OG0003524	2	0	0	4	0	0	6
OG0003525	1	0	0	5	0	0	6
OG0003526	2	0	0	4	0	0	6
OG0003527	4	0	1	0	0	1	6
OG0003528	1	0	1	2	1	1	6
OG0003529	4	0	0	2	0	0	6
OG0003530	2	0	2	0	1	1	6
OG0003531	1	0	1	2	1	1	6
OG0003532	2	0	0	4	0	0	6
OG0003533	3	1	1	0	0	1	6
OG0003534	2	0	0	4	0	0	6
OG0003535	2	0	0	4	0	0	6
OG0003536	2	0	0	2	1	1	6
OG0003537	3	0	1	0	1	1	6
OG0003538	4	0	0	2	0	0	6
OG0003539	3	0	1	0	1	1	6
OG0003540	2	1	1	0	1	1	6
OG0003541	5	0	1	0	0	0	6
OG0003542	2	0	2	2	0	0	6
OG0003543	2	1	1	0	1	1	6
OG0003544	1	0	1	4	0	0	6
OG0003545	4	0	0	2	0	0	6
OG0003546	3	0	1	0	1	1	6
OG0003547	2	0	0	4	0	0	6
OG0003548	3	1	1	0	0	1	6
OG0003549	2	0	0	2	0	2	6
OG0003550	5	1	0	0	0	0	6
OG0003551	1	0	0	5	0	0	6
OG0003552	4	0	0	2	0	0	6
OG0003553	2	0	1	2	0	1	6
OG0003554	1	0	0	5	0	0	6
OG0003555	4	0	0	2	0	0	6
OG0003556	1	0	1	2	1	1	6
OG0003557	2	0	0	2	1	1	6
OG0003558	4	0	1	0	1	0	6
OG0003559	2	0	0	4	0	0	6
OG0003560	1	1	1	2	1	0	6
OG0003561	1	0	1	2	1	1	6
OG0003562	5	0	1	0	0	0	6
OG0003563	3	0	3	0	0	0	6
OG0003564	1	0	1	4	0	0	6
OG0003565	5	0	0	0	0	1	6
OG0003566	1	0	0	4	0	1	6
OG0003567	2	0	0	2	1	1	6
OG0003568	3	0	1	0	0	2	6
OG0003569	4	0	0	2	0	0	6
OG0003570	2	0	1	2	0	1	6
OG0003571	4	0	0	0	1	1	6
OG0003572	2	0	0	4	0	0	6
OG0003573	1	0	0	4	0	1	6
OG0003574	1	0	0	5	0	0	6
OG0003575	5	0	0	1	0	0	6
OG0003576	2	0	0	4	0	0	6
OG0003577	2	0	0	4	0	0	6
OG0003578	2	0	1	2	0	1	6
OG0003579	1	0	0	5	0	0	6
OG0003580	2	1	1	0	1	1	6
OG0003581	3	0	1	0	1	1	6
OG0003582	2	0	0	4	0	0	6
OG0003583	4	1	0	0	1	0	6
OG0003584	1	1	1	1	1	1	6
OG0003585	2	0	0	4	0	0	6
OG0003586	3	0	0	2	0	1	6
OG0003587	2	0	0	4	0	0	6
OG0003588	2	1	3	0	0	0	6
OG0003589	3	0	1	0	0	2	6
OG0003590	2	0	0	4	0	0	6
OG0003591	2	0	0	4	0	0	6
OG0003592	3	0	0	2	1	0	6
OG0003593	2	0	0	4	0	0	6
OG0003594	2	0	0	4	0	0	6
OG0003595	4	0	0	2	0	0	6
OG0003596	2	0	1	2	0	1	6
OG0003597	1	0	1	2	1	1	6
OG0003598	2	1	1	0	1	1	6
OG0003599	2	1	1	0	1	1	6
OG0003600	2	1	2	0	0	1	6
OG0003601	3	0	1	0	1	1	6
OG0003602	2	0	1	2	0	1	6
OG0003603	3	0	0	2	0	1	6
OG0003604	1	0	0	5	0	0	6
OG0003605	2	0	3	0	0	1	6
OG0003606	3	0	2	0	0	1	6
OG0003607	2	1	1	0	1	1	6
OG0003608	1	0	1	2	1	1	6
OG0003609	2	1	1	0	1	1	6
OG0003610	2	0	0	4	0	0	6
OG0003611	2	1	1	0	1	1	6
OG0003612	2	0	0	4	0	0	6
OG0003613	3	1	2	0	0	0	6
OG0003614	1	0	1	4	0	0	6
OG0003615	2	0	0	2	1	1	6
OG0003616	2	0	0	4	0	0	6
OG0003617	1	0	0	4	1	0	6
OG0003618	2	1	1	0	1	1	6
OG0003619	1	3	0	2	0	0	6
OG0003620	1	0	4	0	0	1	6
OG0003621	2	0	2	0	1	1	6
OG0003622	1	0	1	4	0	0	6
OG0003623	1	0	0	5	0	0	6
OG0003624	4	1	1	0	0	0	6
OG0003625	2	1	1	0	1	1	6
OG0003626	1	1	3	0	0	1	6
OG0003627	2	1	1	0	1	1	6
OG0003628	1	0	1	2	1	1	6
OG0003629	1	0	0	5	0	0	6
OG0003630	2	0	4	0	0	0	6
OG0003631	1	2	1	0	1	1	6
OG0003632	1	0	0	5	0	0	6
OG0003633	2	1	1	0	1	1	6
OG0003634	1	0	0	5	0	0	6
OG0003635	3	1	1	0	0	1	6
OG0003636	1	0	1	4	0	0	6
OG0003637	2	1	2	0	0	1	6
OG0003638	2	1	0	0	2	1	6
OG0003639	1	0	1	2	1	1	6
OG0003640	1	0	2	2	0	1	6
OG0003641	2	1	1	0	1	1	6
OG0003642	1	1	1	2	0	1	6
OG0003643	1	0	1	2	1	1	6
OG0003644	1	0	0	5	0	0	6
OG0003645	1	0	0	4	0	1	6
OG0003646	1	0	1	2	1	1	6
OG0003647	2	0	1	2	0	1	6
OG0003648	1	0	1	2	1	1	6
OG0003649	2	0	3	0	0	1	6
OG0003650	1	1	1	2	0	1	6
OG0003651	1	0	0	4	1	0	6
OG0003652	2	1	1	0	1	1	6
OG0003653	2	0	2	0	1	1	6
OG0003654	3	0	0	2	0	1	6
OG0003655	1	0	0	5	0	0	6
OG0003656	1	0	1	4	0	0	6
OG0003657	2	0	0	4	0	0	6
OG0003658	1	0	1	2	1	1	6
OG0003659	1	1	3	0	0	1	6
OG0003660	2	1	1	0	1	1	6
OG0003661	1	0	1	4	0	0	6
OG0003662	1	1	0	2	1	1	6
OG0003663	1	1	2	0	1	1	6
OG0003664	1	0	1	2	1	1	6
OG0003665	1	0	1	4	0	0	6
OG0003666	1	1	1	2	0	1	6
OG0003667	1	0	2	2	0	1	6
OG0003668	1	0	0	5	0	0	6
OG0003669	1	0	2	2	0	1	6
OG0003670	1	1	1	2	0	1	6
OG0003671	2	1	1	0	1	1	6
OG0003672	2	0	0	4	0	0	6
OG0003673	2	0	4	0	0	0	6
OG0003674	1	0	1	2	1	1	6
OG0003675	1	0	1	2	1	1	6
OG0003676	1	0	0	5	0	0	6
OG0003677	1	0	0	4	0	1	6
OG0003678	2	0	0	4	0	0	6
OG0003679	1	0	1	4	0	0	6
OG0003680	1	0	1	2	1	1	6
OG0003681	1	0	1	2	1	1	6
OG0003682	2	1	1	2	0	0	6
OG0003683	1	0	1	2	1	1	6
OG0003684	2	0	1	3	0	0	6
OG0003685	1	0	0	4	0	1	6
OG0003686	2	0	0	4	0	0	6
OG0003687	2	0	0	4	0	0	6
OG0003688	1	1	0	3	1	0	6
OG0003689	2	0	2	0	1	1	6
OG0003690	2	0	2	0	1	1	6
OG0003691	1	1	1	2	0	1	6
OG0003692	3	0	1	1	1	0	6
OG0003693	1	1	0	2	1	1	6
OG0003694	1	0	1	2	1	1	6
OG0003695	3	1	1	0	0	1	6
OG0003696	1	1	1	2	0	1	6
OG0003697	2	1	1	0	1	1	6
OG0003698	4	0	0	2	0	0	6
OG0003699	2	0	1	2	0	1	6
OG0003700	1	0	0	4	1	0	6
OG0003701	4	0	0	2	0	0	6
OG0003702	1	1	1	0	1	2	6
OG0003703	1	0	1	2	1	1	6
OG0003704	2	0	0	4	0	0	6
OG0003705	1	0	1	3	0	1	6
OG0003706	1	0	0	5	0	0	6
OG0003707	1	0	3	0	1	1	6
OG0003708	2	0	0	3	0	1	6
OG0003709	1	0	1	2	1	1	6
OG0003710	1	1	0	2	1	1	6
OG0003711	1	0	0	4	1	0	6
OG0003712	1	0	1	3	0	1	6
OG0003713	1	0	1	2	1	1	6
OG0003714	4	0	0	2	0	0	6
OG0003715	3	0	1	1	0	1	6
OG0003716	1	0	3	1	0	1	6
OG0003717	3	0	1	0	1	1	6
OG0003718	1	0	1	2	1	1	6
OG0003719	1	0	1	2	1	1	6
OG0003720	1	0	0	5	0	0	6
OG0003721	1	0	0	5	0	0	6
OG0003722	2	0	0	4	0	0	6
OG0003723	1	1	2	0	1	1	6
OG0003724	1	1	0	2	1	1	6
OG0003725	2	0	1	3	0	0	6
OG0003726	3	1	0	0	1	1	6
OG0003727	3	0	1	0	2	0	6
OG0003728	2	1	2	0	0	1	6
OG0003729	1	0	1	3	0	1	6
OG0003730	1	2	1	2	0	0	6
OG0003731	2	0	2	0	1	1	6
OG0003732	2	0	3	0	1	0	6
OG0003733	2	0	2	0	1	1	6
OG0003734	1	0	0	3	1	1	6
OG0003735	2	0	0	4	0	0	6
OG0003736	1	1	0	2	1	1	6
OG0003737	1	0	1	3	0	1	6
OG0003738	1	0	1	2	1	1	6
OG0003739	1	1	0	2	1	1	6
OG0003740	1	0	1	3	0	1	6
OG0003741	2	0	0	2	1	1	6
OG0003742	2	1	1	0	1	1	6
OG0003743	1	0	1	2	1	1	6
OG0003744	1	0	1	2	1	1	6
OG0003745	1	0	2	3	0	0	6
OG0003746	1	1	2	0	1	1	6
OG0003747	1	1	1	2	0	1	6
OG0003748	3	0	1	0	1	1	6
OG0003749	3	0	1	0	1	1	6
OG0003750	1	0	1	4	0	0	6
OG0003751	1	0	1	2	1	1	6
OG0003752	0	1	0	3	1	1	6
OG0003753	0	1	2	0	2	1	6
OG0003754	0	1	1	2	1	1	6
OG0003755	0	1	1	2	1	1	6
OG0003756	0	1	2	0	1	2	6
OG0003757	0	1	1	2	1	1	6
OG0003758	0	1	1	2	1	1	6
OG0003759	0	1	1	4	0	0	6
OG0003760	0	2	1	0	1	2	6
OG0003761	0	1	1	4	0	0	6
OG0003762	0	1	1	2	1	1	6
OG0003763	0	1	4	0	0	1	6
OG0003764	0	1	1	3	0	1	6
OG0003765	0	1	1	3	0	1	6
OG0003766	0	1	0	5	0	0	6
OG0003767	0	1	1	2	1	1	6
OG0003768	0	1	0	3	1	1	6
OG0003769	0	1	0	0	3	2	6
OG0003770	0	0	2	4	0	0	6
OG0003771	0	0	5	0	1	0	6
OG0003772	0	0	1	5	0	0	6
OG0003773	0	0	1	3	2	0	6
OG0003774	0	0	6	0	0	0	6
OG0003775	0	0	1	5	0	0	6
OG0003776	0	0	3	3	0	0	6
OG0003777	0	0	1	4	0	1	6
OG0003778	0	0	2	4	0	0	6
OG0003779	0	0	1	5	0	0	6
OG0003780	0	0	1	4	0	1	6
OG0003781	0	0	1	4	1	0	6
OG0003782	0	0	1	4	0	1	6
OG0003783	0	0	1	3	1	1	6
OG0003784	0	0	1	4	0	1	6
OG0003785	0	0	1	5	0	0	6
OG0003786	0	0	1	5	0	0	6
OG0003787	0	0	2	0	2	2	6
OG0003788	0	0	1	4	0	1	6
OG0003789	0	0	0	4	1	1	6
OG0003790	0	0	0	4	1	1	6
OG0003791	0	0	0	4	1	1	6
OG0003792	0	0	0	4	1	1	6
OG0003793	0	0	0	4	1	1	6
OG0003794	0	0	0	4	1	1	6
OG0003795	0	0	0	4	1	1	6
OG0003796	0	0	0	4	1	1	6
OG0003797	0	0	0	6	0	0	6
OG0003798	0	0	0	4	1	1	6
OG0003799	0	0	0	4	1	1	6
OG0003800	0	0	0	6	0	0	6
OG0003801	0	0	0	4	1	1	6
OG0003802	0	0	0	4	1	1	6
OG0003803	0	0	0	5	0	1	6
OG0003804	0	0	0	6	0	0	6
OG0003805	0	0	0	6	0	0	6
OG0003806	0	0	0	6	0	0	6
OG0003807	0	0	0	6	0	0	6
OG0003808	0	0	0	4	1	1	6
OG0003809	0	0	0	6	0	0	6
OG0003810	0	0	0	0	6	0	6
OG0003811	0	0	0	0	0	6	6
OG0003812	1	1	1	0	1	1	5
OG0003813	1	0	0	4	0	0	5
OG0003814	2	0	2	0	1	0	5
OG0003815	2	0	0	3	0	0	5
OG0003816	1	1	0	2	0	1	5
OG0003817	2	1	1	0	0	1	5
OG0003818	1	1	1	0	1	1	5
OG0003819	4	0	1	0	0	0	5
OG0003820	1	0	3	0	0	1	5
OG0003821	1	0	1	0	2	1	5
OG0003822	1	1	0	2	0	1	5
OG0003823	1	0	0	4	0	0	5
OG0003824	3	0	1	0	0	1	5
OG0003825	1	0	0	4	0	0	5
OG0003826	1	0	0	4	0	0	5
OG0003827	1	0	0	2	1	1	5
OG0003828	1	1	0	2	0	1	5
OG0003829	1	1	1	0	1	1	5
OG0003830	1	1	1	0	1	1	5
OG0003831	1	1	1	0	1	1	5
OG0003832	1	0	1	2	0	1	5
OG0003833	1	0	0	4	0	0	5
OG0003834	4	0	1	0	0	0	5
OG0003835	1	0	2	0	1	1	5
OG0003836	2	1	0	0	1	1	5
OG0003837	5	0	0	0	0	0	5
OG0003838	1	1	1	0	1	1	5
OG0003839	3	0	1	0	0	1	5
OG0003840	2	1	0	2	0	0	5
OG0003841	1	0	0	4	0	0	5
OG0003842	1	0	0	4	0	0	5
OG0003843	1	0	0	4	0	0	5
OG0003844	2	0	1	2	0	0	5
OG0003845	1	0	1	3	0	0	5
OG0003846	1	0	2	0	1	1	5
OG0003847	3	0	0	0	1	1	5
OG0003848	2	1	2	0	0	0	5
OG0003849	2	0	0	3	0	0	5
OG0003850	1	0	0	2	1	1	5
OG0003851	2	0	0	3	0	0	5
OG0003852	3	0	0	2	0	0	5
OG0003853	1	0	0	4	0	0	5
OG0003854	3	0	0	0	1	1	5
OG0003855	2	0	0	0	2	1	5
OG0003856	2	0	1	0	1	1	5
OG0003857	2	0	0	2	0	1	5
OG0003858	1	0	1	2	1	0	5
OG0003859	1	0	1	2	0	1	5
OG0003860	1	0	0	4	0	0	5
OG0003861	5	0	0	0	0	0	5
OG0003862	1	0	1	2	0	1	5
OG0003863	2	1	1	0	0	1	5
OG0003864	2	0	1	1	0	1	5
OG0003865	2	0	1	2	0	0	5
OG0003866	1	0	0	4	0	0	5
OG0003867	1	1	1	0	1	1	5
OG0003868	1	2	0	0	1	1	5
OG0003869	1	0	1	2	1	0	5
OG0003870	3	0	0	2	0	0	5
OG0003871	2	0	1	2	0	0	5
OG0003872	1	0	0	2	1	1	5
OG0003873	1	0	1	2	1	0	5
OG0003874	2	1	1	0	0	1	5
OG0003875	1	0	0	2	1	1	5
OG0003876	1	0	0	4	0	0	5
OG0003877	1	0	0	2	1	1	5
OG0003878	1	0	0	4	0	0	5
OG0003879	1	1	1	0	1	1	5
OG0003880	4	0	1	0	0	0	5
OG0003881	1	0	0	4	0	0	5
OG0003882	1	1	1	0	1	1	5
OG0003883	1	0	0	4	0	0	5
OG0003884	1	0	0	4	0	0	5
OG0003885	2	0	1	0	1	1	5
OG0003886	1	0	0	4	0	0	5
OG0003887	2	1	1	0	0	1	5
OG0003888	2	1	0	0	1	1	5
OG0003889	2	1	0	2	0	0	5
OG0003890	3	0	1	0	0	1	5
OG0003891	1	0	1	2	0	1	5
OG0003892	1	0	0	4	0	0	5
OG0003893	3	0	1	1	0	0	5
OG0003894	1	0	0	4	0	0	5
OG0003895	1	0	0	4	0	0	5
OG0003896	1	0	0	4	0	0	5
OG0003897	1	1	1	2	0	0	5
OG0003898	2	1	1	0	0	1	5
OG0003899	2	0	1	2	0	0	5
OG0003900	1	1	1	0	1	1	5
OG0003901	3	0	1	0	0	1	5
OG0003902	3	0	0	2	0	0	5
OG0003903	1	0	0	4	0	0	5
OG0003904	1	0	0	2	1	1	5
OG0003905	1	0	0	4	0	0	5
OG0003906	3	1	1	0	0	0	5
OG0003907	2	0	0	3	0	0	5
OG0003908	1	0	0	4	0	0	5
OG0003909	3	0	1	0	0	1	5
OG0003910	3	0	0	2	0	0	5
OG0003911	1	0	0	4	0	0	5
OG0003912	3	0	0	2	0	0	5
OG0003913	1	1	0	1	0	2	5
OG0003914	2	0	0	3	0	0	5
OG0003915	2	0	1	2	0	0	5
OG0003916	1	1	1	0	1	1	5
OG0003917	2	0	2	0	0	1	5
OG0003918	1	0	0	4	0	0	5
OG0003919	2	0	0	2	1	0	5
OG0003920	2	0	0	3	0	0	5
OG0003921	1	0	1	2	0	1	5
OG0003922	1	0	0	4	0	0	5
OG0003923	1	0	0	4	0	0	5
OG0003924	3	0	0	2	0	0	5
OG0003925	1	0	0	4	0	0	5
OG0003926	1	0	3	0	0	1	5
OG0003927	1	0	0	4	0	0	5
OG0003928	2	0	1	0	1	1	5
OG0003929	1	0	0	4	0	0	5
OG0003930	1	0	0	4	0	0	5
OG0003931	2	0	1	2	0	0	5
OG0003932	3	0	0	2	0	0	5
OG0003933	2	0	0	3	0	0	5
OG0003934	1	0	0	4	0	0	5
OG0003935	1	0	0	4	0	0	5
OG0003936	3	0	1	0	1	0	5
OG0003937	1	0	0	4	0	0	5
OG0003938	3	0	0	0	1	1	5
OG0003939	2	0	1	2	0	0	5
OG0003940	5	0	0	0	0	0	5
OG0003941	1	0	0	4	0	0	5
OG0003942	1	0	0	4	0	0	5
OG0003943	3	0	0	2	0	0	5
OG0003944	1	0	0	4	0	0	5
OG0003945	3	0	1	0	0	1	5
OG0003946	1	0	0	4	0	0	5
OG0003947	2	0	1	0	1	1	5
OG0003948	2	0	0	2	0	1	5
OG0003949	1	0	0	4	0	0	5
OG0003950	1	0	0	4	0	0	5
OG0003951	1	0	0	4	0	0	5
OG0003952	1	0	0	4	0	0	5
OG0003953	3	0	0	2	0	0	5
OG0003954	3	0	0	2	0	0	5
OG0003955	1	0	0	4	0	0	5
OG0003956	1	0	1	2	0	1	5
OG0003957	2	0	1	0	1	1	5
OG0003958	1	0	0	4	0	0	5
OG0003959	4	0	1	0	0	0	5
OG0003960	4	0	1	0	0	0	5
OG0003961	3	0	1	0	0	1	5
OG0003962	3	0	0	2	0	0	5
OG0003963	3	0	0	0	1	1	5
OG0003964	1	0	0	4	0	0	5
OG0003965	2	0	0	3	0	0	5
OG0003966	1	0	0	4	0	0	5
OG0003967	2	0	1	2	0	0	5
OG0003968	4	1	0	0	0	0	5
OG0003969	2	0	0	3	0	0	5
OG0003970	1	0	0	4	0	0	5
OG0003971	1	0	0	4	0	0	5
OG0003972	1	0	0	4	0	0	5
OG0003973	1	0	0	4	0	0	5
OG0003974	1	0	0	4	0	0	5
OG0003975	1	0	0	4	0	0	5
OG0003976	3	0	0	0	1	1	5
OG0003977	1	0	0	4	0	0	5
OG0003978	3	0	0	2	0	0	5
OG0003979	3	0	0	2	0	0	5
OG0003980	1	0	0	4	0	0	5
OG0003981	1	0	0	4	0	0	5
OG0003982	1	0	0	4	0	0	5
OG0003983	1	0	0	4	0	0	5
OG0003984	2	0	1	2	0	0	5
OG0003985	1	0	2	2	0	0	5
OG0003986	2	0	0	2	0	1	5
OG0003987	1	0	0	4	0	0	5
OG0003988	1	0	0	4	0	0	5
OG0003989	1	0	1	2	0	1	5
OG0003990	1	1	0	3	0	0	5
OG0003991	1	0	1	1	1	1	5
OG0003992	1	0	0	4	0	0	5
OG0003993	1	0	0	4	0	0	5
OG0003994	1	1	1	0	1	1	5
OG0003995	1	0	1	3	0	0	5
OG0003996	1	0	0	4	0	0	5
OG0003997	2	0	2	0	0	1	5
OG0003998	1	1	1	0	1	1	5
OG0003999	1	1	1	0	1	1	5
OG0004000	1	0	1	2	0	1	5
OG0004001	1	0	0	4	0	0	5
OG0004002	1	0	0	4	0	0	5
OG0004003	1	0	0	4	0	0	5
OG0004004	1	0	0	4	0	0	5
OG0004005	2	0	1	2	0	0	5
OG0004006	1	1	1	2	0	0	5
OG0004007	1	0	0	4	0	0	5
OG0004008	3	1	1	0	0	0	5
OG0004009	1	0	0	4	0	0	5
OG0004010	1	0	0	4	0	0	5
OG0004011	2	0	1	2	0	0	5
OG0004012	1	0	0	4	0	0	5
OG0004013	1	1	1	0	1	1	5
OG0004014	2	0	1	0	1	1	5
OG0004015	1	1	1	0	1	1	5
OG0004016	1	0	1	0	1	2	5
OG0004017	1	0	0	4	0	0	5
OG0004018	1	0	0	4	0	0	5
OG0004019	1	0	0	4	0	0	5
OG0004020	3	0	0	2	0	0	5
OG0004021	1	0	0	4	0	0	5
OG0004022	1	0	0	4	0	0	5
OG0004023	2	0	1	0	1	1	5
OG0004024	2	0	1	0	1	1	5
OG0004025	1	1	1	0	1	1	5
OG0004026	1	0	1	2	0	1	5
OG0004027	1	0	1	0	1	2	5
OG0004028	2	1	1	0	0	1	5
OG0004029	2	1	2	0	0	0	5
OG0004030	1	0	1	2	0	1	5
OG0004031	1	1	1	0	1	1	5
OG0004032	1	0	0	4	0	0	5
OG0004033	2	0	0	3	0	0	5
OG0004034	1	0	0	4	0	0	5
OG0004035	1	1	1	0	1	1	5
OG0004036	1	0	0	0	1	3	5
OG0004037	1	1	1	0	1	1	5
OG0004038	1	0	1	2	1	0	5
OG0004039	2	0	2	0	1	0	5
OG0004040	1	0	0	4	0	0	5
OG0004041	1	0	0	4	0	0	5
OG0004042	1	0	0	4	0	0	5
OG0004043	1	0	0	4	0	0	5
OG0004044	1	0	1	2	0	1	5
OG0004045	1	0	0	4	0	0	5
OG0004046	2	0	0	2	0	1	5
OG0004047	1	0	0	4	0	0	5
OG0004048	1	0	0	2	1	1	5
OG0004049	1	0	0	4	0	0	5
OG0004050	1	0	0	4	0	0	5
OG0004051	1	1	1	0	1	1	5
OG0004052	1	0	0	4	0	0	5
OG0004053	3	0	1	0	0	1	5
OG0004054	1	0	0	2	1	1	5
OG0004055	1	1	1	0	1	1	5
OG0004056	1	0	0	4	0	0	5
OG0004057	1	0	0	4	0	0	5
OG0004058	1	0	0	4	0	0	5
OG0004059	1	0	0	4	0	0	5
OG0004060	1	0	0	4	0	0	5
OG0004061	1	0	0	4	0	0	5
OG0004062	2	0	1	2	0	0	5
OG0004063	1	0	1	0	0	3	5
OG0004064	1	0	1	2	0	1	5
OG0004065	1	0	0	4	0	0	5
OG0004066	1	0	0	4	0	0	5
OG0004067	2	0	1	2	0	0	5
OG0004068	2	1	0	0	1	1	5
OG0004069	1	0	1	2	0	1	5
OG0004070	2	0	3	0	0	0	5
OG0004071	1	0	1	1	1	1	5
OG0004072	1	0	0	2	1	1	5
OG0004073	1	1	1	0	1	1	5
OG0004074	1	0	0	4	0	0	5
OG0004075	1	0	0	4	0	0	5
OG0004076	2	0	1	2	0	0	5
OG0004077	1	1	1	0	1	1	5
OG0004078	1	0	0	4	0	0	5
OG0004079	1	0	2	0	1	1	5
OG0004080	1	0	0	4	0	0	5
OG0004081	1	0	0	4	0	0	5
OG0004082	2	1	1	0	0	1	5
OG0004083	1	1	3	0	0	0	5
OG0004084	1	1	1	0	1	1	5
OG0004085	1	0	0	4	0	0	5
OG0004086	1	0	0	4	0	0	5
OG0004087	1	0	0	4	0	0	5
OG0004088	1	0	0	4	0	0	5
OG0004089	1	0	0	4	0	0	5
OG0004090	1	0	0	4	0	0	5
OG0004091	4	0	0	0	1	0	5
OG0004092	1	1	1	0	1	1	5
OG0004093	1	0	1	2	1	0	5
OG0004094	1	0	0	4	0	0	5
OG0004095	2	0	2	0	0	1	5
OG0004096	1	0	2	0	1	1	5
OG0004097	1	0	0	4	0	0	5
OG0004098	1	0	0	4	0	0	5
OG0004099	1	0	0	2	1	1	5
OG0004100	1	0	1	2	0	1	5
OG0004101	1	0	3	0	0	1	5
OG0004102	2	0	0	3	0	0	5
OG0004103	2	0	1	0	1	1	5
OG0004104	2	0	1	2	0	0	5
OG0004105	1	0	0	4	0	0	5
OG0004106	1	0	0	4	0	0	5
OG0004107	2	0	1	0	1	1	5
OG0004108	1	0	3	0	1	0	5
OG0004109	2	1	1	0	0	1	5
OG0004110	1	0	0	4	0	0	5
OG0004111	1	0	0	4	0	0	5
OG0004112	1	1	1	0	1	1	5
OG0004113	3	0	1	0	0	1	5
OG0004114	1	0	0	4	0	0	5
OG0004115	1	1	0	2	0	1	5
OG0004116	1	0	1	2	0	1	5
OG0004117	1	0	2	0	1	1	5
OG0004118	2	0	1	0	1	1	5
OG0004119	2	0	0	3	0	0	5
OG0004120	1	1	1	0	1	1	5
OG0004121	1	0	0	2	1	1	5
OG0004122	1	0	0	4	0	0	5
OG0004123	2	0	0	0	2	1	5
OG0004124	2	0	1	0	1	1	5
OG0004125	1	0	1	2	0	1	5
OG0004126	1	0	1	2	0	1	5
OG0004127	1	0	0	3	0	1	5
OG0004128	1	0	0	4	0	0	5
OG0004129	1	0	1	2	0	1	5
OG0004130	1	1	1	0	1	1	5
OG0004131	1	0	0	4	0	0	5
OG0004132	2	0	0	0	2	1	5
OG0004133	1	0	0	4	0	0	5
OG0004134	1	1	1	0	1	1	5
OG0004135	1	0	0	4	0	0	5
OG0004136	2	0	1	0	1	1	5
OG0004137	1	1	1	0	1	1	5
OG0004138	2	0	1	0	1	1	5
OG0004139	2	0	0	2	0	1	5
OG0004140	2	0	1	2	0	0	5
OG0004141	1	1	1	2	0	0	5
OG0004142	2	0	0	3	0	0	5
OG0004143	1	0	0	4	0	0	5
OG0004144	1	0	0	3	0	1	5
OG0004145	1	0	0	4	0	0	5
OG0004146	1	0	0	4	0	0	5
OG0004147	2	2	1	0	0	0	5
OG0004148	1	0	1	2	0	1	5
OG0004149	1	0	0	4	0	0	5
OG0004150	1	0	1	2	0	1	5
OG0004151	1	0	0	4	0	0	5
OG0004152	3	0	1	0	0	1	5
OG0004153	1	0	3	0	0	1	5
OG0004154	2	0	1	2	0	0	5
OG0004155	1	1	1	0	1	1	5
OG0004156	1	0	0	4	0	0	5
OG0004157	1	1	1	0	1	1	5
OG0004158	1	0	0	4	0	0	5
OG0004159	1	0	0	4	0	0	5
OG0004160	1	0	0	4	0	0	5
OG0004161	1	0	0	2	1	1	5
OG0004162	1	0	0	4	0	0	5
OG0004163	3	0	0	2	0	0	5
OG0004164	1	0	2	2	0	0	5
OG0004165	1	0	1	2	0	1	5
OG0004166	2	0	1	2	0	0	5
OG0004167	2	0	1	2	0	0	5
OG0004168	2	0	1	0	1	1	5
OG0004169	1	0	2	0	1	1	5
OG0004170	2	0	0	2	0	1	5
OG0004171	1	0	0	4	0	0	5
OG0004172	1	0	2	0	0	2	5
OG0004173	2	1	1	0	1	0	5
OG0004174	4	0	0	0	0	1	5
OG0004175	2	1	1	0	0	1	5
OG0004176	3	0	0	2	0	0	5
OG0004177	2	0	1	1	1	0	5
OG0004178	2	0	1	0	1	1	5
OG0004179	3	0	1	0	1	0	5
OG0004180	1	0	0	4	0	0	5
OG0004181	3	0	0	2	0	0	5
OG0004182	2	0	0	2	0	1	5
OG0004183	1	0	1	3	0	0	5
OG0004184	1	1	1	0	1	1	5
OG0004185	1	1	1	0	1	1	5
OG0004186	1	0	0	4	0	0	5
OG0004187	1	1	0	2	0	1	5
OG0004188	1	1	1	0	1	1	5
OG0004189	1	1	0	2	0	1	5
OG0004190	3	0	0	2	0	0	5
OG0004191	1	0	1	2	0	1	5
OG0004192	1	1	1	0	1	1	5
OG0004193	2	1	1	0	0	1	5
OG0004194	2	0	1	0	1	1	5
OG0004195	2	0	1	0	1	1	5
OG0004196	3	0	0	2	0	0	5
OG0004197	2	0	1	0	1	1	5
OG0004198	0	1	1	2	0	1	5
OG0004199	0	1	1	0	0	3	5
OG0004200	0	1	2	0	1	1	5
OG0004201	0	1	2	0	1	1	5
OG0004202	0	1	1	0	2	1	5
OG0004203	0	1	1	0	2	1	5
OG0004204	0	1	1	3	0	0	5
OG0004205	0	1	2	0	1	1	5
OG0004206	0	1	0	4	0	0	5
OG0004207	0	1	1	1	1	1	5
OG0004208	0	1	1	2	0	1	5
OG0004209	0	1	2	0	1	1	5
OG0004210	0	1	0	2	1	1	5
OG0004211	0	1	1	2	0	1	5
OG0004212	0	1	1	1	1	1	5
OG0004213	0	1	1	0	1	2	5
OG0004214	0	2	2	0	0	1	5
OG0004215	0	1	3	0	0	1	5
OG0004216	0	1	2	0	1	1	5
OG0004217	0	1	0	0	1	3	5
OG0004218	0	1	1	2	1	0	5
OG0004219	0	1	2	0	1	1	5
OG0004220	0	1	1	0	1	2	5
OG0004221	0	1	0	4	0	0	5
OG0004222	0	1	2	0	1	1	5
OG0004223	0	1	3	0	0	1	5
OG0004224	0	1	3	0	0	1	5
OG0004225	0	1	1	2	0	1	5
OG0004226	0	1	1	1	1	1	5
OG0004227	0	1	0	0	4	0	5
OG0004228	0	1	0	2	1	1	5
OG0004229	0	1	0	2	1	1	5
OG0004230	0	0	1	2	1	1	5
OG0004231	0	0	1	2	1	1	5
OG0004232	0	0	4	0	0	1	5
OG0004233	0	0	1	3	1	0	5
OG0004234	0	0	3	2	0	0	5
OG0004235	0	0	1	2	1	1	5
OG0004236	0	0	1	2	1	1	5
OG0004237	0	0	2	2	0	1	5
OG0004238	0	0	4	0	1	0	5
OG0004239	0	0	4	0	0	1	5
OG0004240	0	0	4	0	1	0	5
OG0004241	0	0	1	2	1	1	5
OG0004242	0	0	1	2	1	1	5
OG0004243	0	0	4	0	0	1	5
OG0004244	0	0	2	2	0	1	5
OG0004245	0	0	1	4	0	0	5
OG0004246	0	0	5	0	0	0	5
OG0004247	0	0	3	2	0	0	5
OG0004248	0	0	1	4	0	0	5
OG0004249	0	0	1	3	0	1	5
OG0004250	0	0	1	4	0	0	5
OG0004251	0	0	1	2	1	1	5
OG0004252	0	0	1	2	1	1	5
OG0004253	0	0	1	2	1	1	5
OG0004254	0	0	1	4	0	0	5
OG0004255	0	0	1	2	1	1	5
OG0004256	0	0	1	4	0	0	5
OG0004257	0	0	1	4	0	0	5
OG0004258	0	0	1	2	1	1	5
OG0004259	0	0	1	2	1	1	5
OG0004260	0	0	1	2	1	1	5
OG0004261	0	0	1	2	1	1	5
OG0004262	0	0	1	2	1	1	5
OG0004263	0	0	1	2	1	1	5
OG0004264	0	0	2	0	1	2	5
OG0004265	0	0	1	4	0	0	5
OG0004266	0	0	3	0	1	1	5
OG0004267	0	0	1	3	0	1	5
OG0004268	0	0	2	2	0	1	5
OG0004269	0	0	1	4	0	0	5
OG0004270	0	0	1	4	0	0	5
OG0004271	0	0	1	2	1	1	5
OG0004272	0	0	1	4	0	0	5
OG0004273	0	0	1	4	0	0	5
OG0004274	0	0	1	2	1	1	5
OG0004275	0	0	1	0	2	2	5
OG0004276	0	0	1	4	0	0	5
OG0004277	0	0	1	0	1	3	5
OG0004278	0	0	1	2	1	1	5
OG0004279	0	0	1	2	1	1	5
OG0004280	0	0	0	2	1	2	5
OG0004281	0	0	0	4	1	0	5
OG0004282	0	0	0	4	0	1	5
OG0004283	0	0	0	4	0	1	5
OG0004284	0	0	0	4	0	1	5
OG0004285	0	0	0	3	1	1	5
OG0004286	0	0	0	5	0	0	5
OG0004287	0	0	0	5	0	0	5
OG0004288	0	0	0	3	1	1	5
OG0004289	0	0	0	4	0	1	5
OG0004290	0	0	0	4	0	1	5
OG0004291	0	0	0	4	0	1	5
OG0004292	0	0	0	5	0	0	5
OG0004293	2	0	0	2	0	0	4
OG0004294	2	0	1	0	0	1	4
OG0004295	2	0	0	2	0	0	4
OG0004296	1	0	0	2	1	0	4
OG0004297	1	0	1	2	0	0	4
OG0004298	2	0	1	0	1	0	4
OG0004299	2	1	0	0	0	1	4
OG0004300	2	0	0	2	0	0	4
OG0004301	1	0	1	0	1	1	4
OG0004302	1	1	1	0	0	1	4
OG0004303	2	0	1	0	0	1	4
OG0004304	2	0	0	2	0	0	4
OG0004305	2	0	0	2	0	0	4
OG0004306	2	0	0	2	0	0	4
OG0004307	2	0	0	2	0	0	4
OG0004308	1	0	1	2	0	0	4
OG0004309	1	1	0	0	1	1	4
OG0004310	1	0	1	2	0	0	4
OG0004311	1	0	1	2	0	0	4
OG0004312	3	0	0	1	0	0	4
OG0004313	1	1	1	0	1	0	4
OG0004314	2	0	0	2	0	0	4
OG0004315	2	0	1	0	0	1	4
OG0004316	3	0	0	0	0	1	4
OG0004317	1	0	1	2	0	0	4
OG0004318	1	0	0	3	0	0	4
OG0004319	1	0	0	3	0	0	4
OG0004320	1	0	2	0	0	1	4
OG0004321	1	0	0	1	2	0	4
OG0004322	2	0	0	0	2	0	4
OG0004323	1	0	1	0	1	1	4
OG0004324	1	1	1	0	0	1	4
OG0004325	1	0	0	2	0	1	4
OG0004326	1	0	2	0	0	1	4
OG0004327	1	1	0	0	1	1	4
OG0004328	1	0	1	0	1	1	4
OG0004329	1	0	1	2	0	0	4
OG0004330	2	0	0	2	0	0	4
OG0004331	2	0	0	2	0	0	4
OG0004332	2	0	0	2	0	0	4
OG0004333	2	0	0	2	0	0	4
OG0004334	2	0	0	2	0	0	4
OG0004335	2	0	0	2	0	0	4
OG0004336	2	1	0	0	0	1	4
OG0004337	2	0	1	0	1	0	4
OG0004338	1	1	1	0	0	1	4
OG0004339	2	0	0	2	0	0	4
OG0004340	1	0	1	2	0	0	4
OG0004341	1	0	1	2	0	0	4
OG0004342	1	0	2	0	0	1	4
OG0004343	1	1	1	0	0	1	4
OG0004344	2	0	1	0	1	0	4
OG0004345	3	0	1	0	0	0	4
OG0004346	1	0	1	2	0	0	4
OG0004347	2	0	0	2	0	0	4
OG0004348	1	0	2	0	0	1	4
OG0004349	1	0	3	0	0	0	4
OG0004350	3	0	0	1	0	0	4
OG0004351	1	1	1	0	0	1	4
OG0004352	1	0	1	2	0	0	4
OG0004353	3	0	1	0	0	0	4
OG0004354	1	0	1	0	1	1	4
OG0004355	1	0	0	3	0	0	4
OG0004356	2	0	0	2	0	0	4
OG0004357	1	0	1	0	1	1	4
OG0004358	2	0	0	2	0	0	4
OG0004359	2	0	0	2	0	0	4
OG0004360	2	0	0	0	1	1	4
OG0004361	2	0	0	2	0	0	4
OG0004362	2	0	0	2	0	0	4
OG0004363	2	0	0	2	0	0	4
OG0004364	2	0	1	0	0	1	4
OG0004365	2	0	0	2	0	0	4
OG0004366	1	0	1	2	0	0	4
OG0004367	3	0	1	0	0	0	4
OG0004368	1	0	1	2	0	0	4
OG0004369	1	1	0	2	0	0	4
OG0004370	1	0	1	0	1	1	4
OG0004371	1	0	0	3	0	0	4
OG0004372	2	0	0	2	0	0	4
OG0004373	1	0	0	3	0	0	4
OG0004374	2	0	0	2	0	0	4
OG0004375	1	1	1	0	0	1	4
OG0004376	1	0	0	3	0	0	4
OG0004377	2	0	0	2	0	0	4
OG0004378	3	0	1	0	0	0	4
OG0004379	2	0	1	0	0	1	4
OG0004380	2	1	0	0	0	1	4
OG0004381	3	0	1	0	0	0	4
OG0004382	1	0	0	3	0	0	4
OG0004383	1	1	0	2	0	0	4
OG0004384	1	1	1	0	0	1	4
OG0004385	3	0	1	0	0	0	4
OG0004386	2	0	0	2	0	0	4
OG0004387	2	0	0	2	0	0	4
OG0004388	1	0	0	3	0	0	4
OG0004389	2	0	0	2	0	0	4
OG0004390	2	0	0	2	0	0	4
OG0004391	2	0	0	2	0	0	4
OG0004392	2	0	1	0	0	1	4
OG0004393	1	0	0	2	0	1	4
OG0004394	1	1	1	0	1	0	4
OG0004395	2	0	0	2	0	0	4
OG0004396	1	0	0	3	0	0	4
OG0004397	1	0	1	0	1	1	4
OG0004398	2	0	0	2	0	0	4
OG0004399	3	0	0	0	0	1	4
OG0004400	2	0	0	2	0	0	4
OG0004401	2	0	0	2	0	0	4
OG0004402	2	0	0	2	0	0	4
OG0004403	2	0	1	0	0	1	4
OG0004404	3	0	0	0	0	1	4
OG0004405	3	0	0	0	0	1	4
OG0004406	1	0	0	3	0	0	4
OG0004407	2	0	0	2	0	0	4
OG0004408	2	0	1	0	0	1	4
OG0004409	2	0	0	2	0	0	4
OG0004410	2	0	0	2	0	0	4
OG0004411	1	0	1	2	0	0	4
OG0004412	1	0	1	0	1	1	4
OG0004413	2	0	0	2	0	0	4
OG0004414	1	0	1	2	0	0	4
OG0004415	2	0	0	2	0	0	4
OG0004416	1	0	0	3	0	0	4
OG0004417	2	0	0	2	0	0	4
OG0004418	2	0	0	0	1	1	4
OG0004419	1	0	1	0	1	1	4
OG0004420	3	0	1	0	0	0	4
OG0004421	3	0	1	0	0	0	4
OG0004422	2	0	0	2	0	0	4
OG0004423	1	0	1	2	0	0	4
OG0004424	3	0	0	1	0	0	4
OG0004425	1	1	1	0	0	1	4
OG0004426	2	0	0	2	0	0	4
OG0004427	2	0	0	2	0	0	4
OG0004428	1	0	1	1	0	1	4
OG0004429	1	0	0	3	0	0	4
OG0004430	3	0	0	0	0	1	4
OG0004431	4	0	0	0	0	0	4
OG0004432	1	0	0	3	0	0	4
OG0004433	2	0	0	2	0	0	4
OG0004434	1	0	1	2	0	0	4
OG0004435	1	0	0	3	0	0	4
OG0004436	2	0	0	2	0	0	4
OG0004437	2	0	1	0	0	1	4
OG0004438	3	0	1	0	0	0	4
OG0004439	3	0	1	0	0	0	4
OG0004440	2	0	0	2	0	0	4
OG0004441	1	0	0	3	0	0	4
OG0004442	1	1	0	2	0	0	4
OG0004443	2	0	0	2	0	0	4
OG0004444	1	1	1	0	0	1	4
OG0004445	1	0	1	0	1	1	4
OG0004446	1	0	1	0	1	1	4
OG0004447	1	1	0	0	1	1	4
OG0004448	2	0	1	0	0	1	4
OG0004449	1	0	1	0	1	1	4
OG0004450	2	0	1	0	1	0	4
OG0004451	1	0	2	0	0	1	4
OG0004452	1	1	1	0	0	1	4
OG0004453	1	0	2	0	0	1	4
OG0004454	2	0	1	0	0	1	4
OG0004455	1	0	0	3	0	0	4
OG0004456	2	0	0	2	0	0	4
OG0004457	2	0	1	0	0	1	4
OG0004458	2	0	0	0	1	1	4
OG0004459	1	0	2	0	0	1	4
OG0004460	1	0	2	0	0	1	4
OG0004461	1	1	1	0	0	1	4
OG0004462	1	0	0	2	0	1	4
OG0004463	2	0	2	0	0	0	4
OG0004464	1	0	1	0	1	1	4
OG0004465	2	0	0	2	0	0	4
OG0004466	1	0	2	0	1	0	4
OG0004467	1	0	1	2	0	0	4
OG0004468	1	1	1	0	1	0	4
OG0004469	1	0	0	3	0	0	4
OG0004470	1	0	1	0	1	1	4
OG0004471	1	1	0	0	1	1	4
OG0004472	1	1	1	0	0	1	4
OG0004473	1	0	0	2	1	0	4
OG0004474	1	0	0	3	0	0	4
OG0004475	1	0	0	3	0	0	4
OG0004476	1	0	0	0	1	2	4
OG0004477	1	0	2	0	0	1	4
OG0004478	1	0	0	2	0	1	4
OG0004479	1	0	1	0	1	1	4
OG0004480	1	0	0	3	0	0	4
OG0004481	1	0	1	0	1	1	4
OG0004482	2	0	0	2	0	0	4
OG0004483	1	1	2	0	0	0	4
OG0004484	1	0	1	0	1	1	4
OG0004485	1	0	1	0	1	1	4
OG0004486	1	0	1	0	1	1	4
OG0004487	1	0	1	0	0	2	4
OG0004488	1	0	2	0	0	1	4
OG0004489	1	0	1	0	1	1	4
OG0004490	1	1	1	0	0	1	4
OG0004491	1	0	0	2	1	0	4
OG0004492	1	0	0	3	0	0	4
OG0004493	1	0	1	0	1	1	4
OG0004494	1	0	1	0	1	1	4
OG0004495	2	0	1	0	1	0	4
OG0004496	1	0	0	3	0	0	4
OG0004497	1	0	0	3	0	0	4
OG0004498	1	0	1	0	1	1	4
OG0004499	1	0	3	0	0	0	4
OG0004500	2	0	0	2	0	0	4
OG0004501	1	1	1	0	0	1	4
OG0004502	1	0	1	0	1	1	4
OG0004503	1	1	0	0	1	1	4
OG0004504	1	0	1	0	1	1	4
OG0004505	2	0	0	2	0	0	4
OG0004506	1	0	1	2	0	0	4
OG0004507	1	0	2	0	0	1	4
OG0004508	1	1	0	2	0	0	4
OG0004509	2	0	2	0	0	0	4
OG0004510	3	0	0	0	0	1	4
OG0004511	1	0	0	3	0	0	4
OG0004512	2	0	0	2	0	0	4
OG0004513	1	1	1	0	0	1	4
OG0004514	1	1	1	0	1	0	4
OG0004515	1	1	0	0	2	0	4
OG0004516	1	1	0	2	0	0	4
OG0004517	1	0	3	0	0	0	4
OG0004518	1	1	1	0	1	0	4
OG0004519	2	0	0	2	0	0	4
OG0004520	1	1	0	0	1	1	4
OG0004521	1	0	0	2	0	1	4
OG0004522	1	0	0	3	0	0	4
OG0004523	1	0	1	1	0	1	4
OG0004524	1	1	1	0	0	1	4
OG0004525	1	0	0	3	0	0	4
OG0004526	1	0	1	0	1	1	4
OG0004527	2	0	0	2	0	0	4
OG0004528	1	1	1	0	0	1	4
OG0004529	1	0	1	0	1	1	4
OG0004530	1	2	1	0	0	0	4
OG0004531	1	1	0	2	0	0	4
OG0004532	1	2	0	0	0	1	4
OG0004533	1	0	1	0	1	1	4
OG0004534	1	1	1	0	0	1	4
OG0004535	2	0	0	2	0	0	4
OG0004536	1	0	1	0	1	1	4
OG0004537	2	0	1	0	0	1	4
OG0004538	1	0	1	0	1	1	4
OG0004539	1	0	0	3	0	0	4
OG0004540	1	1	1	0	0	1	4
OG0004541	1	0	1	0	1	1	4
OG0004542	1	1	2	0	0	0	4
OG0004543	2	0	0	2	0	0	4
OG0004544	1	0	0	3	0	0	4
OG0004545	1	0	0	0	1	2	4
OG0004546	1	0	1	0	1	1	4
OG0004547	1	0	0	2	0	1	4
OG0004548	1	0	1	0	1	1	4
OG0004549	1	1	0	0	1	1	4
OG0004550	1	1	0	0	1	1	4
OG0004551	2	0	0	2	0	0	4
OG0004552	1	1	0	0	1	1	4
OG0004553	1	0	3	0	0	0	4
OG0004554	1	0	1	0	1	1	4
OG0004555	2	0	0	2	0	0	4
OG0004556	1	0	1	0	1	1	4
OG0004557	1	1	1	0	0	1	4
OG0004558	1	0	1	0	1	1	4
OG0004559	1	0	0	3	0	0	4
OG0004560	1	1	0	0	1	1	4
OG0004561	2	0	1	0	0	1	4
OG0004562	2	0	0	2	0	0	4
OG0004563	1	0	0	2	0	1	4
OG0004564	1	0	1	0	1	1	4
OG0004565	1	0	1	2	0	0	4
OG0004566	1	0	1	0	1	1	4
OG0004567	1	0	0	2	1	0	4
OG0004568	1	0	1	0	1	1	4
OG0004569	2	0	1	0	0	1	4
OG0004570	1	0	0	3	0	0	4
OG0004571	1	0	1	0	1	1	4
OG0004572	2	0	0	2	0	0	4
OG0004573	1	0	1	2	0	0	4
OG0004574	1	0	1	2	0	0	4
OG0004575	1	0	0	3	0	0	4
OG0004576	1	0	1	2	0	0	4
OG0004577	1	1	0	1	1	0	4
OG0004578	1	0	1	2	0	0	4
OG0004579	1	0	1	0	1	1	4
OG0004580	3	0	1	0	0	0	4
OG0004581	1	0	1	0	1	1	4
OG0004582	2	1	0	0	0	1	4
OG0004583	1	0	1	0	1	1	4
OG0004584	2	0	0	2	0	0	4
OG0004585	2	0	0	2	0	0	4
OG0004586	1	0	1	0	1	1	4
OG0004587	1	1	1	0	1	0	4
OG0004588	1	0	1	0	1	1	4
OG0004589	1	1	1	0	0	1	4
OG0004590	2	0	0	0	1	1	4
OG0004591	1	0	1	2	0	0	4
OG0004592	2	0	0	2	0	0	4
OG0004593	1	1	0	0	1	1	4
OG0004594	1	0	0	3	0	0	4
OG0004595	1	0	1	0	1	1	4
OG0004596	1	0	1	0	1	1	4
OG0004597	1	0	1	2	0	0	4
OG0004598	1	0	2	0	0	1	4
OG0004599	2	0	1	0	0	1	4
OG0004600	1	0	0	2	0	1	4
OG0004601	1	0	1	2	0	0	4
OG0004602	1	2	0	0	0	1	4
OG0004603	2	0	1	0	0	1	4
OG0004604	3	0	0	0	1	0	4
OG0004605	1	0	1	0	1	1	4
OG0004606	2	0	0	0	1	1	4
OG0004607	2	0	0	2	0	0	4
OG0004608	1	1	0	2	0	0	4
OG0004609	2	0	0	2	0	0	4
OG0004610	2	0	0	0	1	1	4
OG0004611	1	1	0	2	0	0	4
OG0004612	1	0	1	2	0	0	4
OG0004613	1	0	1	0	1	1	4
OG0004614	2	0	0	2	0	0	4
OG0004615	1	0	1	0	1	1	4
OG0004616	1	0	1	0	1	1	4
OG0004617	1	0	1	0	1	1	4
OG0004618	1	0	0	2	0	1	4
OG0004619	1	0	1	2	0	0	4
OG0004620	1	0	0	2	1	0	4
OG0004621	1	0	2	0	0	1	4
OG0004622	2	0	0	1	0	1	4
OG0004623	1	0	1	0	1	1	4
OG0004624	1	0	1	0	1	1	4
OG0004625	1	1	1	0	1	0	4
OG0004626	2	0	0	2	0	0	4
OG0004627	2	0	0	2	0	0	4
OG0004628	2	0	0	0	1	1	4
OG0004629	1	0	1	2	0	0	4
OG0004630	1	0	1	0	0	2	4
OG0004631	2	0	0	2	0	0	4
OG0004632	1	0	2	0	0	1	4
OG0004633	2	0	1	0	0	1	4
OG0004634	1	0	1	0	1	1	4
OG0004635	2	0	0	2	0	0	4
OG0004636	1	0	1	2	0	0	4
OG0004637	2	0	0	2	0	0	4
OG0004638	1	0	0	3	0	0	4
OG0004639	1	0	0	3	0	0	4
OG0004640	2	0	0	2	0	0	4
OG0004641	1	0	1	0	1	1	4
OG0004642	1	0	1	2	0	0	4
OG0004643	1	0	0	3	0	0	4
OG0004644	2	0	0	0	1	1	4
OG0004645	2	0	0	2	0	0	4
OG0004646	1	0	0	3	0	0	4
OG0004647	1	0	1	2	0	0	4
OG0004648	1	0	0	2	1	0	4
OG0004649	2	0	0	2	0	0	4
OG0004650	1	0	1	2	0	0	4
OG0004651	2	0	0	2	0	0	4
OG0004652	1	2	0	0	0	1	4
OG0004653	1	0	0	3	0	0	4
OG0004654	1	0	1	2	0	0	4
OG0004655	1	0	1	0	1	1	4
OG0004656	2	1	0	0	0	1	4
OG0004657	1	0	1	0	1	1	4
OG0004658	1	1	0	0	1	1	4
OG0004659	1	0	0	2	1	0	4
OG0004660	2	0	0	2	0	0	4
OG0004661	2	0	0	2	0	0	4
OG0004662	1	0	1	0	1	1	4
OG0004663	1	1	1	0	0	1	4
OG0004664	1	0	3	0	0	0	4
OG0004665	1	0	1	0	1	1	4
OG0004666	4	0	0	0	0	0	4
OG0004667	2	0	1	0	1	0	4
OG0004668	1	0	1	0	1	1	4
OG0004669	3	0	0	1	0	0	4
OG0004670	2	0	0	2	0	0	4
OG0004671	1	0	1	0	1	1	4
OG0004672	1	0	1	0	1	1	4
OG0004673	0	1	1	0	1	1	4
OG0004674	0	1	1	0	1	1	4
OG0004675	0	1	1	0	1	1	4
OG0004676	0	1	1	0	1	1	4
OG0004677	0	1	2	0	0	1	4
OG0004678	0	1	1	2	0	0	4
OG0004679	0	1	1	0	1	1	4
OG0004680	0	1	1	0	1	1	4
OG0004681	0	2	2	0	0	0	4
OG0004682	0	1	1	0	1	1	4
OG0004683	0	1	1	0	1	1	4
OG0004684	0	1	2	0	0	1	4
OG0004685	0	1	1	0	1	1	4
OG0004686	0	1	1	0	1	1	4
OG0004687	0	1	2	0	1	0	4
OG0004688	0	1	0	2	0	1	4
OG0004689	0	1	1	0	1	1	4
OG0004690	0	1	1	0	1	1	4
OG0004691	0	1	0	0	1	2	4
OG0004692	0	1	0	0	1	2	4
OG0004693	0	1	0	2	0	1	4
OG0004694	0	1	1	0	1	1	4
OG0004695	0	1	1	0	1	1	4
OG0004696	0	1	3	0	0	0	4
OG0004697	0	1	1	0	1	1	4
OG0004698	0	3	0	0	1	0	4
OG0004699	0	1	1	0	1	1	4
OG0004700	0	1	2	1	0	0	4
OG0004701	0	1	1	0	1	1	4
OG0004702	0	1	3	0	0	0	4
OG0004703	0	1	1	0	1	1	4
OG0004704	0	1	1	2	0	0	4
OG0004705	0	1	1	0	1	1	4
OG0004706	0	1	3	0	0	0	4
OG0004707	0	1	1	0	1	1	4
OG0004708	0	1	1	0	1	1	4
OG0004709	0	1	1	0	1	1	4
OG0004710	0	1	1	0	1	1	4
OG0004711	0	1	3	0	0	0	4
OG0004712	0	1	1	0	1	1	4
OG0004713	0	1	1	2	0	0	4
OG0004714	0	1	1	0	1	1	4
OG0004715	0	1	2	0	1	0	4
OG0004716	0	1	1	0	1	1	4
OG0004717	0	1	0	2	0	1	4
OG0004718	0	1	2	0	1	0	4
OG0004719	0	1	2	0	1	0	4
OG0004720	0	1	2	0	0	1	4
OG0004721	0	1	1	0	1	1	4
OG0004722	0	1	1	0	1	1	4
OG0004723	0	1	1	0	1	1	4
OG0004724	0	1	1	0	1	1	4
OG0004725	0	1	0	2	0	1	4
OG0004726	0	1	0	2	1	0	4
OG0004727	0	1	3	0	0	0	4
OG0004728	0	1	0	2	1	0	4
OG0004729	0	1	0	0	2	1	4
OG0004730	0	1	1	0	0	2	4
OG0004731	0	0	1	2	0	1	4
OG0004732	0	0	2	0	1	1	4
OG0004733	0	0	2	0	1	1	4
OG0004734	0	0	2	0	1	1	4
OG0004735	0	0	1	2	1	0	4
OG0004736	0	0	3	0	1	0	4
OG0004737	0	0	4	0	0	0	4
OG0004738	0	0	2	1	1	0	4
OG0004739	0	0	4	0	0	0	4
OG0004740	0	0	3	0	0	1	4
OG0004741	0	0	1	3	0	0	4
OG0004742	0	0	2	0	1	1	4
OG0004743	0	0	1	2	0	1	4
OG0004744	0	0	2	2	0	0	4
OG0004745	0	0	3	0	0	1	4
OG0004746	0	0	2	0	1	1	4
OG0004747	0	0	2	0	1	1	4
OG0004748	0	0	1	2	0	1	4
OG0004749	0	0	2	0	1	1	4
OG0004750	0	0	1	0	2	1	4
OG0004751	0	0	2	0	0	2	4
OG0004752	0	0	2	0	1	1	4
OG0004753	0	0	2	0	0	2	4
OG0004754	0	0	1	1	1	1	4
OG0004755	0	0	2	0	1	1	4
OG0004756	0	0	3	0	0	1	4
OG0004757	0	0	1	2	0	1	4
OG0004758	0	0	2	0	1	1	4
OG0004759	0	0	1	2	0	1	4
OG0004760	0	0	1	2	0	1	4
OG0004761	0	0	1	1	1	1	4
OG0004762	0	0	1	1	1	1	4
OG0004763	0	0	1	2	1	0	4
OG0004764	0	0	2	0	1	1	4
OG0004765	0	0	1	2	0	1	4
OG0004766	0	0	3	0	0	1	4
OG0004767	0	0	1	2	0	1	4
OG0004768	0	0	1	3	0	0	4
OG0004769	0	0	1	2	0	1	4
OG0004770	0	0	1	0	2	1	4
OG0004771	0	0	1	3	0	0	4
OG0004772	0	0	1	2	0	1	4
OG0004773	0	0	1	1	1	1	4
OG0004774	0	0	1	2	0	1	4
OG0004775	0	0	3	0	0	1	4
OG0004776	0	0	1	3	0	0	4
OG0004777	0	0	2	0	0	2	4
OG0004778	0	0	2	0	1	1	4
OG0004779	0	0	1	2	0	1	4
OG0004780	0	0	1	2	0	1	4
OG0004781	0	0	2	0	1	1	4
OG0004782	0	0	1	2	1	0	4
OG0004783	0	0	2	0	1	1	4
OG0004784	0	0	1	2	0	1	4
OG0004785	0	0	1	0	1	2	4
OG0004786	0	0	3	0	0	1	4
OG0004787	0	0	1	3	0	0	4
OG0004788	0	0	2	0	0	2	4
OG0004789	0	0	1	2	0	1	4
OG0004790	0	0	2	0	1	1	4
OG0004791	0	0	0	2	1	1	4
OG0004792	0	0	0	4	0	0	4
OG0004793	0	0	0	4	0	0	4
OG0004794	0	0	0	4	0	0	4
OG0004795	0	0	0	3	0	1	4
OG0004796	0	0	0	4	0	0	4
OG0004797	0	0	0	4	0	0	4
OG0004798	0	0	0	2	1	1	4
OG0004799	0	0	0	2	1	1	4
OG0004800	0	0	0	4	0	0	4
OG0004801	0	0	0	2	0	2	4
OG0004802	0	0	0	4	0	0	4
OG0004803	0	0	0	2	1	1	4
OG0004804	0	0	0	2	1	1	4
OG0004805	0	0	0	4	0	0	4
OG0004806	0	0	0	4	0	0	4
OG0004807	0	0	0	2	1	1	4
OG0004808	0	0	0	4	0	0	4
OG0004809	0	0	0	4	0	0	4
OG0004810	0	0	0	4	0	0	4
OG0004811	0	0	0	2	1	1	4
OG0004812	0	0	0	2	1	1	4
OG0004813	0	0	0	2	1	1	4
OG0004814	0	0	0	4	0	0	4
OG0004815	0	0	0	4	0	0	4
OG0004816	0	0	0	3	1	0	4
OG0004817	0	0	0	4	0	0	4
OG0004818	0	0	0	2	1	1	4
OG0004819	0	0	0	4	0	0	4
OG0004820	0	0	0	4	0	0	4
OG0004821	0	0	0	4	0	0	4
OG0004822	0	0	0	4	0	0	4
OG0004823	0	0	0	2	1	1	4
OG0004824	0	0	0	4	0	0	4
OG0004825	0	0	0	4	0	0	4
OG0004826	0	0	0	4	0	0	4
OG0004827	0	0	0	3	1	0	4
OG0004828	0	0	0	0	1	3	4
OG0004829	0	0	0	0	1	3	4
OG0004830	0	0	0	0	1	3	4
OG0004831	0	0	0	0	0	4	4
OG0004832	1	0	1	0	0	1	3
OG0004833	2	0	0	0	0	1	3
OG0004834	1	0	0	2	0	0	3
OG0004835	1	0	0	2	0	0	3
OG0004836	2	0	1	0	0	0	3
OG0004837	1	0	0	2	0	0	3
OG0004838	2	0	0	0	0	1	3
OG0004839	2	0	1	0	0	0	3
OG0004840	1	0	0	2	0	0	3
OG0004841	2	0	0	1	0	0	3
OG0004842	1	0	0	2	0	0	3
OG0004843	1	0	0	2	0	0	3
OG0004844	1	0	1	0	0	1	3
OG0004845	1	0	1	0	0	1	3
OG0004846	1	0	0	2	0	0	3
OG0004847	1	0	0	2	0	0	3
OG0004848	1	0	0	2	0	0	3
OG0004849	2	0	0	0	0	1	3
OG0004850	2	0	1	0	0	0	3
OG0004851	2	0	0	0	0	1	3
OG0004852	1	0	0	0	1	1	3
OG0004853	1	0	0	2	0	0	3
OG0004854	2	0	1	0	0	0	3
OG0004855	1	0	0	0	1	1	3
OG0004856	1	0	0	2	0	0	3
OG0004857	1	0	0	2	0	0	3
OG0004858	2	0	0	0	0	1	3
OG0004859	1	0	0	2	0	0	3
OG0004860	1	0	0	2	0	0	3
OG0004861	1	0	0	2	0	0	3
OG0004862	1	0	0	2	0	0	3
OG0004863	1	0	0	2	0	0	3
OG0004864	1	0	0	2	0	0	3
OG0004865	1	0	0	2	0	0	3
OG0004866	1	0	1	0	0	1	3
OG0004867	1	0	0	2	0	0	3
OG0004868	1	0	1	0	1	0	3
OG0004869	1	0	0	2	0	0	3
OG0004870	1	0	0	2	0	0	3
OG0004871	2	0	0	0	1	0	3
OG0004872	1	0	0	2	0	0	3
OG0004873	1	0	0	2	0	0	3
OG0004874	1	0	0	2	0	0	3
OG0004875	1	0	2	0	0	0	3
OG0004876	1	0	1	1	0	0	3
OG0004877	1	0	0	2	0	0	3
OG0004878	3	0	0	0	0	0	3
OG0004879	2	0	0	0	0	1	3
OG0004880	2	0	1	0	0	0	3
OG0004881	1	0	0	2	0	0	3
OG0004882	3	0	0	0	0	0	3
OG0004883	1	0	0	2	0	0	3
OG0004884	1	0	0	2	0	0	3
OG0004885	1	0	0	2	0	0	3
OG0004886	1	0	0	0	1	1	3
OG0004887	2	0	0	0	0	1	3
OG0004888	1	0	0	2	0	0	3
OG0004889	2	0	0	0	1	0	3
OG0004890	2	0	1	0	0	0	3
OG0004891	1	0	0	2	0	0	3
OG0004892	1	0	0	2	0	0	3
OG0004893	1	0	0	2	0	0	3
OG0004894	1	0	0	2	0	0	3
OG0004895	2	0	0	0	0	1	3
OG0004896	2	0	1	0	0	0	3
OG0004897	2	0	0	1	0	0	3
OG0004898	1	0	1	0	0	1	3
OG0004899	1	0	0	2	0	0	3
OG0004900	1	0	0	2	0	0	3
OG0004901	3	0	0	0	0	0	3
OG0004902	2	0	1	0	0	0	3
OG0004903	1	0	0	2	0	0	3
OG0004904	1	0	0	2	0	0	3
OG0004905	2	0	0	1	0	0	3
OG0004906	2	0	0	0	1	0	3
OG0004907	1	0	0	2	0	0	3
OG0004908	1	0	0	2	0	0	3
OG0004909	1	0	0	2	0	0	3
OG0004910	1	0	0	2	0	0	3
OG0004911	1	0	0	2	0	0	3
OG0004912	1	0	0	2	0	0	3
OG0004913	1	0	0	2	0	0	3
OG0004914	1	0	0	2	0	0	3
OG0004915	1	0	0	2	0	0	3
OG0004916	1	0	0	2	0	0	3
OG0004917	2	0	0	0	1	0	3
OG0004918	2	0	0	1	0	0	3
OG0004919	1	0	0	2	0	0	3
OG0004920	1	0	2	0	0	0	3
OG0004921	3	0	0	0	0	0	3
OG0004922	1	0	0	2	0	0	3
OG0004923	2	0	1	0	0	0	3
OG0004924	1	0	0	2	0	0	3
OG0004925	1	0	0	2	0	0	3
OG0004926	1	0	0	2	0	0	3
OG0004927	1	0	0	2	0	0	3
OG0004928	1	0	0	2	0	0	3
OG0004929	1	0	0	2	0	0	3
OG0004930	1	0	0	2	0	0	3
OG0004931	1	0	1	0	0	1	3
OG0004932	1	0	0	2	0	0	3
OG0004933	1	0	0	2	0	0	3
OG0004934	2	0	0	0	0	1	3
OG0004935	1	0	0	2	0	0	3
OG0004936	1	0	0	2	0	0	3
OG0004937	1	0	0	2	0	0	3
OG0004938	1	0	0	2	0	0	3
OG0004939	1	0	0	2	0	0	3
OG0004940	1	0	0	2	0	0	3
OG0004941	1	0	0	2	0	0	3
OG0004942	2	0	0	0	0	1	3
OG0004943	1	0	0	2	0	0	3
OG0004944	1	0	0	2	0	0	3
OG0004945	1	0	0	2	0	0	3
OG0004946	1	0	1	0	1	0	3
OG0004947	1	0	0	2	0	0	3
OG0004948	1	0	0	2	0	0	3
OG0004949	1	0	1	0	0	1	3
OG0004950	1	0	0	2	0	0	3
OG0004951	1	0	0	2	0	0	3
OG0004952	2	0	1	0	0	0	3
OG0004953	1	0	1	0	0	1	3
OG0004954	1	0	0	2	0	0	3
OG0004955	1	0	0	2	0	0	3
OG0004956	1	0	0	2	0	0	3
OG0004957	1	0	0	2	0	0	3
OG0004958	1	0	0	2	0	0	3
OG0004959	2	0	0	0	0	1	3
OG0004960	1	0	0	2	0	0	3
OG0004961	1	0	0	2	0	0	3
OG0004962	2	0	1	0	0	0	3
OG0004963	2	0	0	0	0	1	3
OG0004964	1	1	0	0	0	1	3
OG0004965	1	0	0	2	0	0	3
OG0004966	1	0	0	2	0	0	3
OG0004967	1	0	0	2	0	0	3
OG0004968	1	0	0	2	0	0	3
OG0004969	1	0	0	2	0	0	3
OG0004970	1	0	0	2	0	0	3
OG0004971	1	0	0	2	0	0	3
OG0004972	1	0	0	2	0	0	3
OG0004973	1	0	0	2	0	0	3
OG0004974	1	0	0	2	0	0	3
OG0004975	1	0	0	2	0	0	3
OG0004976	1	0	0	2	0	0	3
OG0004977	1	0	0	2	0	0	3
OG0004978	1	0	0	2	0	0	3
OG0004979	1	0	1	0	0	1	3
OG0004980	1	1	1	0	0	0	3
OG0004981	1	0	0	2	0	0	3
OG0004982	1	0	0	2	0	0	3
OG0004983	1	0	0	2	0	0	3
OG0004984	1	0	0	1	0	1	3
OG0004985	2	0	0	0	0	1	3
OG0004986	1	0	0	2	0	0	3
OG0004987	1	0	0	2	0	0	3
OG0004988	1	0	2	0	0	0	3
OG0004989	1	0	0	2	0	0	3
OG0004990	2	0	0	1	0	0	3
OG0004991	1	0	0	2	0	0	3
OG0004992	1	0	1	0	0	1	3
OG0004993	1	0	0	2	0	0	3
OG0004994	1	0	0	2	0	0	3
OG0004995	1	0	0	2	0	0	3
OG0004996	1	0	0	2	0	0	3
OG0004997	1	0	0	2	0	0	3
OG0004998	1	0	0	2	0	0	3
OG0004999	1	0	0	2	0	0	3
OG0005000	1	0	0	2	0	0	3
OG0005001	1	0	0	2	0	0	3
OG0005002	1	0	0	2	0	0	3
OG0005003	1	0	1	0	1	0	3
OG0005004	2	0	1	0	0	0	3
OG0005005	1	0	0	2	0	0	3
OG0005006	1	0	0	2	0	0	3
OG0005007	1	0	0	2	0	0	3
OG0005008	2	0	0	1	0	0	3
OG0005009	1	0	0	2	0	0	3
OG0005010	2	0	0	1	0	0	3
OG0005011	2	0	0	0	1	0	3
OG0005012	1	0	0	2	0	0	3
OG0005013	1	0	0	2	0	0	3
OG0005014	1	0	0	2	0	0	3
OG0005015	1	0	0	2	0	0	3
OG0005016	1	0	0	2	0	0	3
OG0005017	1	0	0	2	0	0	3
OG0005018	1	0	0	2	0	0	3
OG0005019	1	0	0	2	0	0	3
OG0005020	1	0	0	2	0	0	3
OG0005021	2	0	1	0	0	0	3
OG0005022	3	0	0	0	0	0	3
OG0005023	1	0	0	2	0	0	3
OG0005024	1	0	0	2	0	0	3
OG0005025	1	0	0	2	0	0	3
OG0005026	2	0	1	0	0	0	3
OG0005027	1	0	0	2	0	0	3
OG0005028	1	0	0	2	0	0	3
OG0005029	1	0	0	2	0	0	3
OG0005030	1	0	2	0	0	0	3
OG0005031	1	0	0	2	0	0	3
OG0005032	2	0	1	0	0	0	3
OG0005033	1	0	0	0	1	1	3
OG0005034	2	0	1	0	0	0	3
OG0005035	1	0	0	2	0	0	3
OG0005036	1	0	1	0	0	1	3
OG0005037	1	0	0	2	0	0	3
OG0005038	1	0	0	2	0	0	3
OG0005039	1	0	0	2	0	0	3
OG0005040	1	0	0	2	0	0	3
OG0005041	1	0	0	2	0	0	3
OG0005042	1	0	0	2	0	0	3
OG0005043	1	0	0	2	0	0	3
OG0005044	1	0	0	2	0	0	3
OG0005045	1	0	2	0	0	0	3
OG0005046	1	0	0	2	0	0	3
OG0005047	1	0	0	2	0	0	3
OG0005048	1	0	0	2	0	0	3
OG0005049	1	0	0	2	0	0	3
OG0005050	1	0	0	2	0	0	3
OG0005051	1	0	1	0	0	1	3
OG0005052	1	0	0	2	0	0	3
OG0005053	1	0	0	2	0	0	3
OG0005054	1	0	0	2	0	0	3
OG0005055	1	0	0	2	0	0	3
OG0005056	1	0	0	2	0	0	3
OG0005057	1	0	0	2	0	0	3
OG0005058	1	0	1	0	0	1	3
OG0005059	1	0	0	2	0	0	3
OG0005060	1	0	0	2	0	0	3
OG0005061	1	0	0	2	0	0	3
OG0005062	1	0	1	0	0	1	3
OG0005063	1	1	0	0	0	1	3
OG0005064	1	0	0	2	0	0	3
OG0005065	1	0	0	2	0	0	3
OG0005066	1	0	0	2	0	0	3
OG0005067	1	0	1	0	0	1	3
OG0005068	1	0	0	2	0	0	3
OG0005069	1	0	0	2	0	0	3
OG0005070	1	0	0	2	0	0	3
OG0005071	1	0	0	2	0	0	3
OG0005072	1	0	0	0	1	1	3
OG0005073	1	0	0	2	0	0	3
OG0005074	1	0	0	2	0	0	3
OG0005075	1	0	1	0	0	1	3
OG0005076	1	1	1	0	0	0	3
OG0005077	1	0	0	2	0	0	3
OG0005078	1	0	0	2	0	0	3
OG0005079	1	0	0	2	0	0	3
OG0005080	1	0	0	2	0	0	3
OG0005081	1	0	0	2	0	0	3
OG0005082	1	0	0	2	0	0	3
OG0005083	1	0	0	2	0	0	3
OG0005084	1	0	0	2	0	0	3
OG0005085	1	0	0	2	0	0	3
OG0005086	1	0	1	0	0	1	3
OG0005087	1	0	0	2	0	0	3
OG0005088	1	0	1	0	0	1	3
OG0005089	1	0	0	2	0	0	3
OG0005090	1	0	0	2	0	0	3
OG0005091	1	0	0	2	0	0	3
OG0005092	1	0	1	0	0	1	3
OG0005093	1	0	0	2	0	0	3
OG0005094	1	0	1	0	0	1	3
OG0005095	1	0	0	2	0	0	3
OG0005096	1	0	2	0	0	0	3
OG0005097	1	0	0	2	0	0	3
OG0005098	1	0	1	0	0	1	3
OG0005099	1	0	0	2	0	0	3
OG0005100	1	0	0	0	1	1	3
OG0005101	1	0	1	0	0	1	3
OG0005102	1	0	0	0	1	1	3
OG0005103	1	1	0	0	0	1	3
OG0005104	1	0	0	2	0	0	3
OG0005105	1	0	0	2	0	0	3
OG0005106	1	0	0	2	0	0	3
OG0005107	1	0	0	2	0	0	3
OG0005108	1	0	0	2	0	0	3
OG0005109	1	0	0	2	0	0	3
OG0005110	1	0	0	2	0	0	3
OG0005111	1	0	0	2	0	0	3
OG0005112	1	0	0	2	0	0	3
OG0005113	1	0	0	2	0	0	3
OG0005114	1	0	0	2	0	0	3
OG0005115	1	0	0	2	0	0	3
OG0005116	1	0	0	2	0	0	3
OG0005117	1	0	1	0	0	1	3
OG0005118	1	0	0	2	0	0	3
OG0005119	1	0	0	2	0	0	3
OG0005120	1	1	0	0	0	1	3
OG0005121	1	0	0	2	0	0	3
OG0005122	1	0	0	2	0	0	3
OG0005123	1	0	0	2	0	0	3
OG0005124	1	0	1	1	0	0	3
OG0005125	1	0	0	2	0	0	3
OG0005126	1	0	0	2	0	0	3
OG0005127	1	1	0	0	0	1	3
OG0005128	1	0	0	2	0	0	3
OG0005129	1	0	0	2	0	0	3
OG0005130	1	0	0	2	0	0	3
OG0005131	1	0	0	2	0	0	3
OG0005132	1	0	0	2	0	0	3
OG0005133	1	0	0	2	0	0	3
OG0005134	1	0	0	2	0	0	3
OG0005135	1	0	0	2	0	0	3
OG0005136	1	0	1	0	0	1	3
OG0005137	1	0	0	2	0	0	3
OG0005138	1	0	2	0	0	0	3
OG0005139	1	1	0	0	0	1	3
OG0005140	1	0	0	2	0	0	3
OG0005141	1	0	0	2	0	0	3
OG0005142	1	0	0	0	0	2	3
OG0005143	1	0	0	2	0	0	3
OG0005144	1	0	0	2	0	0	3
OG0005145	1	0	0	2	0	0	3
OG0005146	1	0	0	2	0	0	3
OG0005147	1	0	0	2	0	0	3
OG0005148	1	0	1	0	0	1	3
OG0005149	1	0	0	2	0	0	3
OG0005150	1	0	0	0	1	1	3
OG0005151	1	0	0	2	0	0	3
OG0005152	1	0	1	0	0	1	3
OG0005153	1	0	0	2	0	0	3
OG0005154	1	0	0	2	0	0	3
OG0005155	1	0	0	2	0	0	3
OG0005156	1	0	0	2	0	0	3
OG0005157	1	0	0	2	0	0	3
OG0005158	1	0	0	0	1	1	3
OG0005159	1	0	1	0	0	1	3
OG0005160	1	0	2	0	0	0	3
OG0005161	1	0	0	2	0	0	3
OG0005162	1	0	0	2	0	0	3
OG0005163	1	0	0	2	0	0	3
OG0005164	1	0	0	2	0	0	3
OG0005165	1	0	2	0	0	0	3
OG0005166	1	0	0	2	0	0	3
OG0005167	1	0	1	0	0	1	3
OG0005168	1	0	1	0	0	1	3
OG0005169	1	0	1	0	0	1	3
OG0005170	1	0	0	2	0	0	3
OG0005171	1	0	0	2	0	0	3
OG0005172	1	0	0	2	0	0	3
OG0005173	1	0	0	2	0	0	3
OG0005174	1	0	1	0	0	1	3
OG0005175	1	0	0	2	0	0	3
OG0005176	1	0	0	2	0	0	3
OG0005177	1	0	0	2	0	0	3
OG0005178	1	0	1	0	0	1	3
OG0005179	1	0	1	0	1	0	3
OG0005180	1	1	0	0	0	1	3
OG0005181	1	0	0	2	0	0	3
OG0005182	1	0	0	0	1	1	3
OG0005183	1	0	0	2	0	0	3
OG0005184	1	0	0	2	0	0	3
OG0005185	1	0	0	2	0	0	3
OG0005186	1	0	0	2	0	0	3
OG0005187	1	0	0	2	0	0	3
OG0005188	1	0	2	0	0	0	3
OG0005189	1	0	0	2	0	0	3
OG0005190	1	0	0	2	0	0	3
OG0005191	1	0	0	2	0	0	3
OG0005192	1	0	0	2	0	0	3
OG0005193	1	0	0	2	0	0	3
OG0005194	1	0	0	2	0	0	3
OG0005195	1	0	0	0	1	1	3
OG0005196	1	0	0	2	0	0	3
OG0005197	1	0	0	2	0	0	3
OG0005198	1	0	0	0	1	1	3
OG0005199	1	0	0	2	0	0	3
OG0005200	1	0	0	2	0	0	3
OG0005201	1	0	0	2	0	0	3
OG0005202	1	0	2	0	0	0	3
OG0005203	1	0	0	2	0	0	3
OG0005204	1	0	0	2	0	0	3
OG0005205	1	0	1	0	0	1	3
OG0005206	2	0	0	0	0	1	3
OG0005207	1	0	0	2	0	0	3
OG0005208	1	0	2	0	0	0	3
OG0005209	1	0	0	2	0	0	3
OG0005210	1	1	1	0	0	0	3
OG0005211	1	0	0	2	0	0	3
OG0005212	1	1	0	0	0	1	3
OG0005213	1	0	0	2	0	0	3
OG0005214	1	0	0	2	0	0	3
OG0005215	1	0	0	2	0	0	3
OG0005216	1	0	0	2	0	0	3
OG0005217	1	0	1	0	0	1	3
OG0005218	1	0	0	2	0	0	3
OG0005219	1	0	0	2	0	0	3
OG0005220	2	0	1	0	0	0	3
OG0005221	1	0	0	0	1	1	3
OG0005222	1	0	0	2	0	0	3
OG0005223	1	0	1	0	0	1	3
OG0005224	1	0	0	2	0	0	3
OG0005225	1	0	0	2	0	0	3
OG0005226	1	0	0	2	0	0	3
OG0005227	1	0	1	0	0	1	3
OG0005228	1	0	0	2	0	0	3
OG0005229	1	0	0	2	0	0	3
OG0005230	1	0	0	0	1	1	3
OG0005231	1	0	2	0	0	0	3
OG0005232	1	0	0	2	0	0	3
OG0005233	1	0	1	1	0	0	3
OG0005234	1	0	0	2	0	0	3
OG0005235	1	0	0	2	0	0	3
OG0005236	1	0	0	2	0	0	3
OG0005237	1	0	0	2	0	0	3
OG0005238	1	0	0	2	0	0	3
OG0005239	1	0	0	2	0	0	3
OG0005240	1	0	0	2	0	0	3
OG0005241	1	0	0	2	0	0	3
OG0005242	1	0	1	0	0	1	3
OG0005243	1	0	1	0	0	1	3
OG0005244	1	0	2	0	0	0	3
OG0005245	1	0	0	2	0	0	3
OG0005246	1	0	0	2	0	0	3
OG0005247	1	0	0	2	0	0	3
OG0005248	1	0	0	2	0	0	3
OG0005249	1	0	1	0	0	1	3
OG0005250	1	0	2	0	0	0	3
OG0005251	1	0	0	2	0	0	3
OG0005252	1	0	1	0	0	1	3
OG0005253	1	0	1	0	1	0	3
OG0005254	2	0	0	1	0	0	3
OG0005255	1	0	0	2	0	0	3
OG0005256	1	0	0	2	0	0	3
OG0005257	1	1	1	0	0	0	3
OG0005258	1	0	1	0	0	1	3
OG0005259	1	0	0	2	0	0	3
OG0005260	2	0	0	1	0	0	3
OG0005261	1	0	2	0	0	0	3
OG0005262	1	0	0	2	0	0	3
OG0005263	1	0	0	2	0	0	3
OG0005264	2	0	0	0	0	1	3
OG0005265	1	0	1	0	0	1	3
OG0005266	1	0	0	2	0	0	3
OG0005267	1	0	0	2	0	0	3
OG0005268	1	0	2	0	0	0	3
OG0005269	1	0	2	0	0	0	3
OG0005270	1	0	0	2	0	0	3
OG0005271	1	0	2	0	0	0	3
OG0005272	1	0	1	0	1	0	3
OG0005273	1	0	1	0	1	0	3
OG0005274	1	0	0	2	0	0	3
OG0005275	1	0	0	2	0	0	3
OG0005276	1	0	1	0	0	1	3
OG0005277	1	0	0	2	0	0	3
OG0005278	1	0	0	2	0	0	3
OG0005279	1	0	0	0	1	1	3
OG0005280	1	0	0	2	0	0	3
OG0005281	1	0	0	2	0	0	3
OG0005282	1	0	0	2	0	0	3
OG0005283	1	0	1	0	0	1	3
OG0005284	1	0	1	0	0	1	3
OG0005285	1	0	0	2	0	0	3
OG0005286	1	0	0	2	0	0	3
OG0005287	1	0	0	2	0	0	3
OG0005288	1	0	1	0	0	1	3
OG0005289	1	0	0	2	0	0	3
OG0005290	1	0	2	0	0	0	3
OG0005291	1	0	0	2	0	0	3
OG0005292	2	0	0	0	1	0	3
OG0005293	1	0	0	2	0	0	3
OG0005294	1	0	1	0	0	1	3
OG0005295	1	0	0	2	0	0	3
OG0005296	1	0	1	0	0	1	3
OG0005297	1	0	0	2	0	0	3
OG0005298	1	0	0	2	0	0	3
OG0005299	1	0	1	0	0	1	3
OG0005300	1	1	0	0	0	1	3
OG0005301	1	0	0	2	0	0	3
OG0005302	1	0	0	2	0	0	3
OG0005303	1	0	2	0	0	0	3
OG0005304	1	0	0	2	0	0	3
OG0005305	1	0	0	2	0	0	3
OG0005306	1	0	1	0	0	1	3
OG0005307	1	0	0	2	0	0	3
OG0005308	1	0	0	2	0	0	3
OG0005309	1	0	1	0	0	1	3
OG0005310	1	0	0	0	1	1	3
OG0005311	1	0	0	2	0	0	3
OG0005312	1	0	0	2	0	0	3
OG0005313	1	0	0	2	0	0	3
OG0005314	1	0	0	0	1	1	3
OG0005315	1	0	1	0	0	1	3
OG0005316	1	0	1	0	0	1	3
OG0005317	1	0	0	2	0	0	3
OG0005318	1	0	0	2	0	0	3
OG0005319	1	0	0	1	0	1	3
OG0005320	1	0	0	0	1	1	3
OG0005321	1	0	0	2	0	0	3
OG0005322	1	0	0	2	0	0	3
OG0005323	1	0	0	0	1	1	3
OG0005324	1	1	0	0	0	1	3
OG0005325	1	0	1	0	0	1	3
OG0005326	2	0	1	0	0	0	3
OG0005327	1	0	2	0	0	0	3
OG0005328	1	0	0	2	0	0	3
OG0005329	1	0	0	2	0	0	3
OG0005330	1	0	0	2	0	0	3
OG0005331	1	0	1	0	0	1	3
OG0005332	2	0	1	0	0	0	3
OG0005333	1	0	1	0	0	1	3
OG0005334	1	0	0	2	0	0	3
OG0005335	2	0	1	0	0	0	3
OG0005336	1	0	0	2	0	0	3
OG0005337	1	1	1	0	0	0	3
OG0005338	1	0	0	0	1	1	3
OG0005339	1	0	0	2	0	0	3
OG0005340	1	0	0	2	0	0	3
OG0005341	1	0	1	0	0	1	3
OG0005342	1	0	0	2	0	0	3
OG0005343	1	0	0	2	0	0	3
OG0005344	1	0	0	1	0	1	3
OG0005345	1	0	0	0	1	1	3
OG0005346	1	0	0	2	0	0	3
OG0005347	1	0	0	2	0	0	3
OG0005348	1	0	2	0	0	0	3
OG0005349	1	0	0	2	0	0	3
OG0005350	1	0	0	2	0	0	3
OG0005351	1	0	0	2	0	0	3
OG0005352	1	0	0	2	0	0	3
OG0005353	1	0	0	0	1	1	3
OG0005354	2	0	0	0	0	1	3
OG0005355	1	0	2	0	0	0	3
OG0005356	1	0	0	2	0	0	3
OG0005357	1	0	0	2	0	0	3
OG0005358	1	0	0	2	0	0	3
OG0005359	1	1	1	0	0	0	3
OG0005360	1	0	0	2	0	0	3
OG0005361	1	0	0	2	0	0	3
OG0005362	1	0	0	0	1	1	3
OG0005363	1	0	0	2	0	0	3
OG0005364	1	0	0	2	0	0	3
OG0005365	1	0	0	2	0	0	3
OG0005366	1	1	1	0	0	0	3
OG0005367	1	0	0	2	0	0	3
OG0005368	1	0	1	0	0	1	3
OG0005369	1	0	0	2	0	0	3
OG0005370	1	0	0	2	0	0	3
OG0005371	1	0	1	0	0	1	3
OG0005372	1	0	1	0	0	1	3
OG0005373	1	0	0	2	0	0	3
OG0005374	1	1	0	0	0	1	3
OG0005375	1	0	0	2	0	0	3
OG0005376	1	0	0	2	0	0	3
OG0005377	1	1	1	0	0	0	3
OG0005378	1	0	0	2	0	0	3
OG0005379	1	0	0	2	0	0	3
OG0005380	0	1	0	0	0	2	3
OG0005381	0	1	2	0	0	0	3
OG0005382	0	1	0	0	1	1	3
OG0005383	0	1	0	0	1	1	3
OG0005384	0	1	0	0	1	1	3
OG0005385	0	1	1	0	0	1	3
OG0005386	0	1	1	0	0	1	3
OG0005387	0	1	0	0	1	1	3
OG0005388	0	1	0	0	1	1	3
OG0005389	0	1	1	0	1	0	3
OG0005390	0	1	1	0	0	1	3
OG0005391	0	1	0	0	1	1	3
OG0005392	0	1	0	0	1	1	3
OG0005393	0	1	1	0	0	1	3
OG0005394	0	2	0	0	0	1	3
OG0005395	0	1	0	0	1	1	3
OG0005396	0	1	1	0	0	1	3
OG0005397	0	1	2	0	0	0	3
OG0005398	0	1	0	0	1	1	3
OG0005399	0	1	1	0	0	1	3
OG0005400	0	1	1	0	0	1	3
OG0005401	0	1	0	0	1	1	3
OG0005402	0	2	1	0	0	0	3
OG0005403	0	1	2	0	0	0	3
OG0005404	0	1	0	0	1	1	3
OG0005405	0	2	1	0	0	0	3
OG0005406	0	2	0	0	1	0	3
OG0005407	0	1	1	0	1	0	3
OG0005408	0	1	0	0	1	1	3
OG0005409	0	1	0	0	1	1	3
OG0005410	0	1	0	0	1	1	3
OG0005411	0	1	2	0	0	0	3
OG0005412	0	1	1	0	0	1	3
OG0005413	0	1	1	0	0	1	3
OG0005414	0	1	0	2	0	0	3
OG0005415	0	1	0	0	1	1	3
OG0005416	0	1	1	0	0	1	3
OG0005417	0	1	0	0	1	1	3
OG0005418	0	1	0	2	0	0	3
OG0005419	0	1	1	0	0	1	3
OG0005420	0	1	1	0	0	1	3
OG0005421	0	1	0	0	1	1	3
OG0005422	0	1	0	2	0	0	3
OG0005423	0	1	1	0	0	1	3
OG0005424	0	1	2	0	0	0	3
OG0005425	0	1	1	0	0	1	3
OG0005426	0	1	1	0	0	1	3
OG0005427	0	1	0	0	1	1	3
OG0005428	0	1	0	0	1	1	3
OG0005429	0	1	1	0	0	1	3
OG0005430	0	1	1	0	0	1	3
OG0005431	0	1	0	0	1	1	3
OG0005432	0	1	0	2	0	0	3
OG0005433	0	1	1	0	0	1	3
OG0005434	0	1	1	0	0	1	3
OG0005435	0	1	0	0	1	1	3
OG0005436	0	1	2	0	0	0	3
OG0005437	0	1	0	0	1	1	3
OG0005438	0	1	0	0	1	1	3
OG0005439	0	1	1	0	1	0	3
OG0005440	0	1	1	0	0	1	3
OG0005441	0	1	1	0	0	1	3
OG0005442	0	1	0	0	1	1	3
OG0005443	0	1	0	0	1	1	3
OG0005444	0	1	1	0	0	1	3
OG0005445	0	1	1	0	0	1	3
OG0005446	0	1	0	0	1	1	3
OG0005447	0	1	0	0	1	1	3
OG0005448	0	2	1	0	0	0	3
OG0005449	0	1	2	0	0	0	3
OG0005450	0	1	0	0	1	1	3
OG0005451	0	1	2	0	0	0	3
OG0005452	0	1	1	0	1	0	3
OG0005453	0	1	0	0	1	1	3
OG0005454	0	1	0	0	1	1	3
OG0005455	0	1	1	0	1	0	3
OG0005456	0	1	1	0	0	1	3
OG0005457	0	1	1	0	0	1	3
OG0005458	0	2	1	0	0	0	3
OG0005459	0	1	0	0	1	1	3
OG0005460	0	1	1	0	0	1	3
OG0005461	0	1	1	0	0	1	3
OG0005462	0	1	0	0	1	1	3
OG0005463	0	1	0	0	1	1	3
OG0005464	0	1	1	0	0	1	3
OG0005465	0	0	3	0	0	0	3
OG0005466	0	0	1	0	1	1	3
OG0005467	0	0	1	0	1	1	3
OG0005468	0	0	1	0	1	1	3
OG0005469	0	0	2	0	0	1	3
OG0005470	0	0	1	0	1	1	3
OG0005471	0	0	1	0	1	1	3
OG0005472	0	0	3	0	0	0	3
OG0005473	0	0	2	0	0	1	3
OG0005474	0	0	2	0	1	0	3
OG0005475	0	0	1	0	1	1	3
OG0005476	0	0	2	0	0	1	3
OG0005477	0	0	1	0	1	1	3
OG0005478	0	0	1	0	1	1	3
OG0005479	0	0	2	0	0	1	3
OG0005480	0	0	1	0	0	2	3
OG0005481	0	0	3	0	0	0	3
OG0005482	0	0	1	0	1	1	3
OG0005483	0	0	1	0	0	2	3
OG0005484	0	0	1	0	1	1	3
OG0005485	0	0	2	0	0	1	3
OG0005486	0	0	2	0	0	1	3
OG0005487	0	0	1	0	1	1	3
OG0005488	0	0	1	0	1	1	3
OG0005489	0	0	1	0	1	1	3
OG0005490	0	0	2	0	1	0	3
OG0005491	0	0	1	2	0	0	3
OG0005492	0	0	1	0	1	1	3
OG0005493	0	0	1	0	1	1	3
OG0005494	0	0	1	0	1	1	3
OG0005495	0	0	3	0	0	0	3
OG0005496	0	0	1	0	1	1	3
OG0005497	0	0	2	0	0	1	3
OG0005498	0	0	2	0	1	0	3
OG0005499	0	0	1	0	1	1	3
OG0005500	0	0	1	0	1	1	3
OG0005501	0	0	1	2	0	0	3
OG0005502	0	0	2	0	0	1	3
OG0005503	0	0	1	2	0	0	3
OG0005504	0	0	1	0	1	1	3
OG0005505	0	0	1	0	1	1	3
OG0005506	0	0	1	0	1	1	3
OG0005507	0	0	1	0	1	1	3
OG0005508	0	0	1	0	1	1	3
OG0005509	0	0	2	0	1	0	3
OG0005510	0	0	1	0	1	1	3
OG0005511	0	0	1	2	0	0	3
OG0005512	0	0	1	2	0	0	3
OG0005513	0	0	1	0	1	1	3
OG0005514	0	0	1	0	1	1	3
OG0005515	0	0	1	0	1	1	3
OG0005516	0	0	2	0	1	0	3
OG0005517	0	0	1	0	1	1	3
OG0005518	0	0	1	0	1	1	3
OG0005519	0	0	3	0	0	0	3
OG0005520	0	0	2	0	0	1	3
OG0005521	0	0	1	0	1	1	3
OG0005522	0	0	1	2	0	0	3
OG0005523	0	0	1	0	1	1	3
OG0005524	0	0	1	0	1	1	3
OG0005525	0	0	1	0	1	1	3
OG0005526	0	0	1	0	1	1	3
OG0005527	0	0	1	0	1	1	3
OG0005528	0	0	1	0	0	2	3
OG0005529	0	0	1	0	1	1	3
OG0005530	0	0	2	0	0	1	3
OG0005531	0	0	1	0	1	1	3
OG0005532	0	0	3	0	0	0	3
OG0005533	0	0	2	0	0	1	3
OG0005534	0	0	1	0	1	1	3
OG0005535	0	0	1	0	1	1	3
OG0005536	0	0	3	0	0	0	3
OG0005537	0	0	1	2	0	0	3
OG0005538	0	0	1	2	0	0	3
OG0005539	0	0	1	0	1	1	3
OG0005540	0	0	2	0	0	1	3
OG0005541	0	0	2	0	0	1	3
OG0005542	0	0	2	0	0	1	3
OG0005543	0	0	1	0	1	1	3
OG0005544	0	0	1	0	1	1	3
OG0005545	0	0	1	2	0	0	3
OG0005546	0	0	1	0	1	1	3
OG0005547	0	0	1	0	1	1	3
OG0005548	0	0	1	0	1	1	3
OG0005549	0	0	1	0	1	1	3
OG0005550	0	0	2	0	0	1	3
OG0005551	0	0	1	0	0	2	3
OG0005552	0	0	1	0	1	1	3
OG0005553	0	0	1	0	1	1	3
OG0005554	0	0	1	0	0	2	3
OG0005555	0	0	1	0	1	1	3
OG0005556	0	0	1	0	1	1	3
OG0005557	0	0	1	0	1	1	3
OG0005558	0	0	1	0	1	1	3
OG0005559	0	0	2	0	0	1	3
OG0005560	0	0	1	0	0	2	3
OG0005561	0	0	1	0	1	1	3
OG0005562	0	0	1	0	1	1	3
OG0005563	0	0	1	2	0	0	3
OG0005564	0	0	2	0	0	1	3
OG0005565	0	0	1	0	1	1	3
OG0005566	0	0	1	1	0	1	3
OG0005567	0	0	1	2	0	0	3
OG0005568	0	0	1	0	1	1	3
OG0005569	0	0	1	0	1	1	3
OG0005570	0	0	1	0	1	1	3
OG0005571	0	0	1	2	0	0	3
OG0005572	0	0	1	0	1	1	3
OG0005573	0	0	1	0	1	1	3
OG0005574	0	0	1	0	1	1	3
OG0005575	0	0	1	0	1	1	3
OG0005576	0	0	1	0	1	1	3
OG0005577	0	0	1	2	0	0	3
OG0005578	0	0	2	0	0	1	3
OG0005579	0	0	1	2	0	0	3
OG0005580	0	0	1	0	1	1	3
OG0005581	0	0	2	0	0	1	3
OG0005582	0	0	2	0	0	1	3
OG0005583	0	0	2	0	0	1	3
OG0005584	0	0	1	0	1	1	3
OG0005585	0	0	1	0	1	1	3
OG0005586	0	0	1	0	1	1	3
OG0005587	0	0	1	0	1	1	3
OG0005588	0	0	1	0	1	1	3
OG0005589	0	0	1	0	1	1	3
OG0005590	0	0	1	0	0	2	3
OG0005591	0	0	1	2	0	0	3
OG0005592	0	0	1	2	0	0	3
OG0005593	0	0	1	0	1	1	3
OG0005594	0	0	1	0	1	1	3
OG0005595	0	0	1	0	1	1	3
OG0005596	0	0	1	0	1	1	3
OG0005597	0	0	1	0	1	1	3
OG0005598	0	0	2	0	0	1	3
OG0005599	0	0	1	2	0	0	3
OG0005600	0	0	1	0	1	1	3
OG0005601	0	0	2	0	1	0	3
OG0005602	0	0	1	0	1	1	3
OG0005603	0	0	1	0	1	1	3
OG0005604	0	0	1	0	0	2	3
OG0005605	0	0	1	0	1	1	3
OG0005606	0	0	1	0	1	1	3
OG0005607	0	0	1	2	0	0	3
OG0005608	0	0	1	2	0	0	3
OG0005609	0	0	2	0	0	1	3
OG0005610	0	0	1	2	0	0	3
OG0005611	0	0	1	0	1	1	3
OG0005612	0	0	1	0	1	1	3
OG0005613	0	0	2	0	0	1	3
OG0005614	0	0	1	0	1	1	3
OG0005615	0	0	2	0	0	1	3
OG0005616	0	0	1	2	0	0	3
OG0005617	0	0	1	0	1	1	3
OG0005618	0	0	1	2	0	0	3
OG0005619	0	0	1	2	0	0	3
OG0005620	0	0	1	0	1	1	3
OG0005621	0	0	1	2	0	0	3
OG0005622	0	0	1	0	1	1	3
OG0005623	0	0	1	0	1	1	3
OG0005624	0	0	1	0	1	1	3
OG0005625	0	0	1	1	1	0	3
OG0005626	0	0	2	0	0	1	3
OG0005627	0	0	0	2	1	0	3
OG0005628	0	0	0	2	1	0	3
OG0005629	0	0	0	2	1	0	3
OG0005630	0	0	0	2	0	1	3
OG0005631	0	0	0	2	0	1	3
OG0005632	0	0	0	2	0	1	3
OG0005633	0	0	0	2	0	1	3
OG0005634	0	0	0	2	0	1	3
OG0005635	0	0	0	2	1	0	3
OG0005636	0	0	0	3	0	0	3
OG0005637	0	0	0	2	0	1	3
OG0005638	0	0	0	3	0	0	3
OG0005639	0	0	0	2	0	1	3
OG0005640	0	0	0	1	1	1	3
OG0005641	0	0	0	2	0	1	3
OG0005642	0	0	0	2	0	1	3
OG0005643	0	0	0	3	0	0	3
OG0005644	0	0	0	1	1	1	3
OG0005645	0	0	0	3	0	0	3
OG0005646	0	0	0	2	0	1	3
OG0005647	0	0	0	0	2	1	3
OG0005648	0	0	0	0	2	1	3
OG0005649	0	0	0	0	1	2	3
OG0005650	0	0	0	0	2	1	3
OG0005651	0	0	0	0	1	2	3
OG0005652	0	0	0	0	2	1	3
OG0005653	0	0	0	0	1	2	3
OG0005654	0	0	0	0	1	2	3
OG0005655	0	0	0	0	1	2	3
OG0005656	0	0	0	0	1	2	3
OG0005657	0	0	0	0	1	2	3
OG0005658	0	0	0	0	1	2	3
OG0005659	0	0	0	0	1	2	3
OG0005660	0	0	0	0	0	3	3
OG0005661	0	0	0	0	0	3	3
OG0005662	1	0	0	0	0	1	2
OG0005663	1	0	1	0	0	0	2
OG0005664	1	0	1	0	0	0	2
OG0005665	1	0	1	0	0	0	2
OG0005666	1	0	0	1	0	0	2
OG0005667	1	0	0	1	0	0	2
OG0005668	1	0	1	0	0	0	2
OG0005669	1	0	1	0	0	0	2
OG0005670	1	0	1	0	0	0	2
OG0005671	1	0	0	0	0	1	2
OG0005672	1	0	0	0	1	0	2
OG0005673	1	0	1	0	0	0	2
OG0005674	1	0	0	1	0	0	2
OG0005675	1	0	1	0	0	0	2
OG0005676	1	1	0	0	0	0	2
OG0005677	1	0	0	0	0	1	2
OG0005678	1	0	1	0	0	0	2
OG0005679	1	0	1	0	0	0	2
OG0005680	1	0	1	0	0	0	2
OG0005681	2	0	0	0	0	0	2
OG0005682	1	0	1	0	0	0	2
OG0005683	1	0	1	0	0	0	2
OG0005684	1	0	1	0	0	0	2
OG0005685	1	0	0	0	0	1	2
OG0005686	1	0	1	0	0	0	2
OG0005687	1	0	0	1	0	0	2
OG0005688	1	0	1	0	0	0	2
OG0005689	1	0	1	0	0	0	2
OG0005690	1	0	1	0	0	0	2
OG0005691	1	0	1	0	0	0	2
OG0005692	1	0	0	0	0	1	2
OG0005693	1	0	1	0	0	0	2
OG0005694	1	0	1	0	0	0	2
OG0005695	1	0	1	0	0	0	2
OG0005696	1	0	1	0	0	0	2
OG0005697	1	0	1	0	0	0	2
OG0005698	1	0	1	0	0	0	2
OG0005699	1	0	0	0	1	0	2
OG0005700	1	0	1	0	0	0	2
OG0005701	1	0	0	1	0	0	2
OG0005702	1	0	0	1	0	0	2
OG0005703	1	0	1	0	0	0	2
OG0005704	1	0	1	0	0	0	2
OG0005705	1	0	1	0	0	0	2
OG0005706	1	0	0	1	0	0	2
OG0005707	1	0	0	1	0	0	2
OG0005708	1	0	0	1	0	0	2
OG0005709	1	0	1	0	0	0	2
OG0005710	1	0	0	0	0	1	2
OG0005711	1	0	1	0	0	0	2
OG0005712	1	0	0	1	0	0	2
OG0005713	1	0	0	1	0	0	2
OG0005714	1	0	0	1	0	0	2
OG0005715	1	0	0	0	1	0	2
OG0005716	2	0	0	0	0	0	2
OG0005717	1	0	0	1	0	0	2
OG0005718	1	0	1	0	0	0	2
OG0005719	1	0	1	0	0	0	2
OG0005720	1	0	1	0	0	0	2
OG0005721	1	0	1	0	0	0	2
OG0005722	1	0	0	1	0	0	2
OG0005723	1	0	0	0	0	1	2
OG0005724	1	0	1	0	0	0	2
OG0005725	1	0	1	0	0	0	2
OG0005726	1	0	1	0	0	0	2
OG0005727	1	0	1	0	0	0	2
OG0005728	1	0	1	0	0	0	2
OG0005729	1	0	0	1	0	0	2
OG0005730	1	1	0	0	0	0	2
OG0005731	1	0	1	0	0	0	2
OG0005732	1	0	0	0	0	1	2
OG0005733	1	0	1	0	0	0	2
OG0005734	1	0	1	0	0	0	2
OG0005735	1	0	1	0	0	0	2
OG0005736	1	0	1	0	0	0	2
OG0005737	1	0	0	1	0	0	2
OG0005738	1	0	0	1	0	0	2
OG0005739	1	0	0	1	0	0	2
OG0005740	1	0	1	0	0	0	2
OG0005741	1	0	1	0	0	0	2
OG0005742	1	0	1	0	0	0	2
OG0005743	1	0	1	0	0	0	2
OG0005744	1	0	0	0	0	1	2
OG0005745	1	0	1	0	0	0	2
OG0005746	1	0	1	0	0	0	2
OG0005747	1	0	1	0	0	0	2
OG0005748	1	0	0	1	0	0	2
OG0005749	1	0	0	0	0	1	2
OG0005750	1	0	0	0	0	1	2
OG0005751	1	0	1	0	0	0	2
OG0005752	1	0	0	1	0	0	2
OG0005753	1	0	1	0	0	0	2
OG0005754	2	0	0	0	0	0	2
OG0005755	1	0	1	0	0	0	2
OG0005756	1	0	1	0	0	0	2
OG0005757	1	0	1	0	0	0	2
OG0005758	1	0	1	0	0	0	2
OG0005759	1	0	0	1	0	0	2
OG0005760	1	0	1	0	0	0	2
OG0005761	1	0	1	0	0	0	2
OG0005762	1	0	0	1	0	0	2
OG0005763	1	0	0	1	0	0	2
OG0005764	1	0	1	0	0	0	2
OG0005765	1	0	0	1	0	0	2
OG0005766	1	0	0	0	1	0	2
OG0005767	1	0	1	0	0	0	2
OG0005768	1	0	0	1	0	0	2
OG0005769	1	0	0	0	0	1	2
OG0005770	1	0	1	0	0	0	2
OG0005771	1	0	1	0	0	0	2
OG0005772	1	0	0	0	1	0	2
OG0005773	1	0	0	1	0	0	2
OG0005774	1	0	0	1	0	0	2
OG0005775	1	0	0	0	0	1	2
OG0005776	1	0	1	0	0	0	2
OG0005777	1	0	1	0	0	0	2
OG0005778	1	0	0	0	1	0	2
OG0005779	1	0	1	0	0	0	2
OG0005780	1	0	0	0	0	1	2
OG0005781	1	0	1	0	0	0	2
OG0005782	1	0	0	0	0	1	2
OG0005783	1	0	1	0	0	0	2
OG0005784	1	0	1	0	0	0	2
OG0005785	1	0	1	0	0	0	2
OG0005786	1	0	0	0	1	0	2
OG0005787	1	0	0	1	0	0	2
OG0005788	1	0	1	0	0	0	2
OG0005789	1	0	1	0	0	0	2
OG0005790	1	0	0	0	0	1	2
OG0005791	1	0	1	0	0	0	2
OG0005792	1	0	0	0	0	1	2
OG0005793	1	0	1	0	0	0	2
OG0005794	1	0	1	0	0	0	2
OG0005795	1	0	0	0	0	1	2
OG0005796	1	0	1	0	0	0	2
OG0005797	1	0	0	0	0	1	2
OG0005798	2	0	0	0	0	0	2
OG0005799	1	0	1	0	0	0	2
OG0005800	1	0	0	0	0	1	2
OG0005801	1	0	0	0	0	1	2
OG0005802	1	0	0	0	0	1	2
OG0005803	1	0	1	0	0	0	2
OG0005804	1	0	0	0	0	1	2
OG0005805	1	0	1	0	0	0	2
OG0005806	1	0	1	0	0	0	2
OG0005807	1	0	1	0	0	0	2
OG0005808	1	0	1	0	0	0	2
OG0005809	1	0	1	0	0	0	2
OG0005810	1	0	1	0	0	0	2
OG0005811	1	0	1	0	0	0	2
OG0005812	1	0	1	0	0	0	2
OG0005813	1	0	1	0	0	0	2
OG0005814	1	0	0	1	0	0	2
OG0005815	1	0	1	0	0	0	2
OG0005816	1	0	1	0	0	0	2
OG0005817	1	0	1	0	0	0	2
OG0005818	1	0	0	0	0	1	2
OG0005819	1	0	0	0	1	0	2
OG0005820	1	0	0	1	0	0	2
OG0005821	1	0	1	0	0	0	2
OG0005822	1	0	0	0	0	1	2
OG0005823	1	0	1	0	0	0	2
OG0005824	1	0	1	0	0	0	2
OG0005825	1	0	1	0	0	0	2
OG0005826	1	0	1	0	0	0	2
OG0005827	1	0	1	0	0	0	2
OG0005828	1	0	1	0	0	0	2
OG0005829	1	0	1	0	0	0	2
OG0005830	1	0	1	0	0	0	2
OG0005831	1	0	1	0	0	0	2
OG0005832	1	0	0	0	0	1	2
OG0005833	2	0	0	0	0	0	2
OG0005834	1	0	0	0	1	0	2
OG0005835	2	0	0	0	0	0	2
OG0005836	2	0	0	0	0	0	2
OG0005837	1	0	1	0	0	0	2
OG0005838	1	0	1	0	0	0	2
OG0005839	1	0	0	0	0	1	2
OG0005840	1	0	1	0	0	0	2
OG0005841	2	0	0	0	0	0	2
OG0005842	1	0	1	0	0	0	2
OG0005843	1	0	1	0	0	0	2
OG0005844	1	0	1	0	0	0	2
OG0005845	1	0	1	0	0	0	2
OG0005846	0	1	1	0	0	0	2
OG0005847	0	1	0	0	0	1	2
OG0005848	0	1	1	0	0	0	2
OG0005849	0	1	0	0	0	1	2
OG0005850	0	1	1	0	0	0	2
OG0005851	0	1	0	0	0	1	2
OG0005852	0	1	1	0	0	0	2
OG0005853	0	1	1	0	0	0	2
OG0005854	0	1	0	0	0	1	2
OG0005855	0	1	1	0	0	0	2
OG0005856	0	1	0	0	0	1	2
OG0005857	0	1	0	0	0	1	2
OG0005858	0	1	1	0	0	0	2
OG0005859	0	1	0	0	0	1	2
OG0005860	0	1	0	0	0	1	2
OG0005861	0	1	0	0	1	0	2
OG0005862	0	1	0	0	0	1	2
OG0005863	0	1	0	0	0	1	2
OG0005864	0	1	0	0	0	1	2
OG0005865	0	1	1	0	0	0	2
OG0005866	0	1	1	0	0	0	2
OG0005867	0	1	1	0	0	0	2
OG0005868	0	1	0	0	0	1	2
OG0005869	0	1	1	0	0	0	2
OG0005870	0	1	1	0	0	0	2
OG0005871	0	1	0	0	1	0	2
OG0005872	0	1	0	0	1	0	2
OG0005873	0	1	1	0	0	0	2
OG0005874	0	1	1	0	0	0	2
OG0005875	0	1	1	0	0	0	2
OG0005876	0	1	1	0	0	0	2
OG0005877	0	1	1	0	0	0	2
OG0005878	0	1	1	0	0	0	2
OG0005879	0	2	0	0	0	0	2
OG0005880	0	1	0	0	0	1	2
OG0005881	0	1	1	0	0	0	2
OG0005882	0	1	0	0	0	1	2
OG0005883	0	1	1	0	0	0	2
OG0005884	0	1	1	0	0	0	2
OG0005885	0	1	0	0	0	1	2
OG0005886	0	1	1	0	0	0	2
OG0005887	0	1	1	0	0	0	2
OG0005888	0	1	1	0	0	0	2
OG0005889	0	1	0	0	0	1	2
OG0005890	0	1	1	0	0	0	2
OG0005891	0	1	1	0	0	0	2
OG0005892	0	2	0	0	0	0	2
OG0005893	0	1	0	0	0	1	2
OG0005894	0	1	1	0	0	0	2
OG0005895	0	1	1	0	0	0	2
OG0005896	0	1	1	0	0	0	2
OG0005897	0	1	0	0	0	1	2
OG0005898	0	1	1	0	0	0	2
OG0005899	0	1	0	0	0	1	2
OG0005900	0	1	1	0	0	0	2
OG0005901	0	1	1	0	0	0	2
OG0005902	0	1	0	0	0	1	2
OG0005903	0	1	1	0	0	0	2
OG0005904	0	1	1	0	0	0	2
OG0005905	0	1	1	0	0	0	2
OG0005906	0	1	0	0	1	0	2
OG0005907	0	1	1	0	0	0	2
OG0005908	0	1	1	0	0	0	2
OG0005909	0	1	1	0	0	0	2
OG0005910	0	1	0	0	0	1	2
OG0005911	0	1	1	0	0	0	2
OG0005912	0	1	0	0	1	0	2
OG0005913	0	1	1	0	0	0	2
OG0005914	0	1	1	0	0	0	2
OG0005915	0	1	1	0	0	0	2
OG0005916	0	1	1	0	0	0	2
OG0005917	0	1	1	0	0	0	2
OG0005918	0	1	0	0	0	1	2
OG0005919	0	1	0	0	1	0	2
OG0005920	0	1	0	0	1	0	2
OG0005921	0	1	1	0	0	0	2
OG0005922	0	1	0	0	0	1	2
OG0005923	0	1	1	0	0	0	2
OG0005924	0	0	1	0	0	1	2
OG0005925	0	0	1	0	0	1	2
OG0005926	0	0	1	0	0	1	2
OG0005927	0	0	1	0	0	1	2
OG0005928	0	0	1	0	0	1	2
OG0005929	0	0	1	0	0	1	2
OG0005930	0	0	1	0	0	1	2
OG0005931	0	0	1	0	0	1	2
OG0005932	0	0	1	0	1	0	2
OG0005933	0	0	1	0	0	1	2
OG0005934	0	0	1	0	0	1	2
OG0005935	0	0	1	0	0	1	2
OG0005936	0	0	1	0	1	0	2
OG0005937	0	0	1	0	0	1	2
OG0005938	0	0	1	0	0	1	2
OG0005939	0	0	2	0	0	0	2
OG0005940	0	0	1	0	0	1	2
OG0005941	0	0	1	0	0	1	2
OG0005942	0	0	1	0	0	1	2
OG0005943	0	0	1	0	0	1	2
OG0005944	0	0	1	0	0	1	2
OG0005945	0	0	1	0	0	1	2
OG0005946	0	0	1	0	0	1	2
OG0005947	0	0	1	0	0	1	2
OG0005948	0	0	1	0	1	0	2
OG0005949	0	0	1	0	0	1	2
OG0005950	0	0	1	0	1	0	2
OG0005951	0	0	1	0	1	0	2
OG0005952	0	0	1	0	0	1	2
OG0005953	0	0	1	1	0	0	2
OG0005954	0	0	2	0	0	0	2
OG0005955	0	0	1	0	1	0	2
OG0005956	0	0	1	0	0	1	2
OG0005957	0	0	1	0	0	1	2
OG0005958	0	0	1	0	0	1	2
OG0005959	0	0	1	0	0	1	2
OG0005960	0	0	1	0	0	1	2
OG0005961	0	0	1	0	0	1	2
OG0005962	0	0	1	0	0	1	2
OG0005963	0	0	1	0	0	1	2
OG0005964	0	0	1	0	1	0	2
OG0005965	0	0	1	0	0	1	2
OG0005966	0	0	1	0	0	1	2
OG0005967	0	0	1	0	0	1	2
OG0005968	0	0	1	0	0	1	2
OG0005969	0	0	1	0	0	1	2
OG0005970	0	0	1	0	0	1	2
OG0005971	0	0	1	0	0	1	2
OG0005972	0	0	2	0	0	0	2
OG0005973	0	0	1	0	0	1	2
OG0005974	0	0	1	0	1	0	2
OG0005975	0	0	1	0	0	1	2
OG0005976	0	0	1	0	0	1	2
OG0005977	0	0	1	0	1	0	2
OG0005978	0	0	1	0	0	1	2
OG0005979	0	0	1	0	0	1	2
OG0005980	0	0	1	0	0	1	2
OG0005981	0	0	1	0	0	1	2
OG0005982	0	0	1	0	0	1	2
OG0005983	0	0	1	0	0	1	2
OG0005984	0	0	1	0	0	1	2
OG0005985	0	0	1	0	0	1	2
OG0005986	0	0	1	0	0	1	2
OG0005987	0	0	2	0	0	0	2
OG0005988	0	0	1	0	0	1	2
OG0005989	0	0	1	0	1	0	2
OG0005990	0	0	1	0	0	1	2
OG0005991	0	0	1	0	0	1	2
OG0005992	0	0	1	0	0	1	2
OG0005993	0	0	1	0	0	1	2
OG0005994	0	0	1	0	0	1	2
OG0005995	0	0	1	0	0	1	2
OG0005996	0	0	1	0	0	1	2
OG0005997	0	0	1	0	1	0	2
OG0005998	0	0	1	0	0	1	2
OG0005999	0	0	1	0	0	1	2
OG0006000	0	0	1	0	0	1	2
OG0006001	0	0	1	0	0	1	2
OG0006002	0	0	1	0	1	0	2
OG0006003	0	0	1	0	0	1	2
OG0006004	0	0	1	0	0	1	2
OG0006005	0	0	1	0	0	1	2
OG0006006	0	0	1	0	1	0	2
OG0006007	0	0	1	0	0	1	2
OG0006008	0	0	1	0	0	1	2
OG0006009	0	0	1	0	0	1	2
OG0006010	0	0	1	0	0	1	2
OG0006011	0	0	1	0	0	1	2
OG0006012	0	0	1	0	0	1	2
OG0006013	0	0	1	0	1	0	2
OG0006014	0	0	1	0	0	1	2
OG0006015	0	0	1	0	0	1	2
OG0006016	0	0	1	0	0	1	2
OG0006017	0	0	2	0	0	0	2
OG0006018	0	0	2	0	0	0	2
OG0006019	0	0	1	0	0	1	2
OG0006020	0	0	1	0	0	1	2
OG0006021	0	0	1	0	0	1	2
OG0006022	0	0	1	0	1	0	2
OG0006023	0	0	1	0	0	1	2
OG0006024	0	0	1	0	0	1	2
OG0006025	0	0	1	0	0	1	2
OG0006026	0	0	1	0	0	1	2
OG0006027	0	0	1	0	0	1	2
OG0006028	0	0	2	0	0	0	2
OG0006029	0	0	1	0	0	1	2
OG0006030	0	0	1	0	0	1	2
OG0006031	0	0	1	0	0	1	2
OG0006032	0	0	1	0	0	1	2
OG0006033	0	0	1	0	0	1	2
OG0006034	0	0	1	0	0	1	2
OG0006035	0	0	1	0	0	1	2
OG0006036	0	0	1	0	1	0	2
OG0006037	0	0	1	0	0	1	2
OG0006038	0	0	1	0	0	1	2
OG0006039	0	0	2	0	0	0	2
OG0006040	0	0	1	0	1	0	2
OG0006041	0	0	1	0	0	1	2
OG0006042	0	0	1	0	0	1	2
OG0006043	0	0	1	0	0	1	2
OG0006044	0	0	1	0	0	1	2
OG0006045	0	0	1	0	0	1	2
OG0006046	0	0	1	0	0	1	2
OG0006047	0	0	1	0	0	1	2
OG0006048	0	0	1	0	0	1	2
OG0006049	0	0	1	0	1	0	2
OG0006050	0	0	1	0	0	1	2
OG0006051	0	0	1	0	0	1	2
OG0006052	0	0	1	0	0	1	2
OG0006053	0	0	1	0	0	1	2
OG0006054	0	0	1	0	0	1	2
OG0006055	0	0	2	0	0	0	2
OG0006056	0	0	1	0	0	1	2
OG0006057	0	0	1	0	0	1	2
OG0006058	0	0	1	0	0	1	2
OG0006059	0	0	1	0	0	1	2
OG0006060	0	0	1	0	0	1	2
OG0006061	0	0	1	0	0	1	2
OG0006062	0	0	1	0	1	0	2
OG0006063	0	0	1	0	0	1	2
OG0006064	0	0	1	0	1	0	2
OG0006065	0	0	1	0	1	0	2
OG0006066	0	0	1	0	1	0	2
OG0006067	0	0	1	0	0	1	2
OG0006068	0	0	1	0	0	1	2
OG0006069	0	0	1	0	0	1	2
OG0006070	0	0	1	0	0	1	2
OG0006071	0	0	1	0	0	1	2
OG0006072	0	0	1	0	0	1	2
OG0006073	0	0	1	0	0	1	2
OG0006074	0	0	1	0	0	1	2
OG0006075	0	0	1	0	0	1	2
OG0006076	0	0	1	0	0	1	2
OG0006077	0	0	1	0	0	1	2
OG0006078	0	0	1	0	0	1	2
OG0006079	0	0	1	0	0	1	2
OG0006080	0	0	1	0	0	1	2
OG0006081	0	0	1	0	0	1	2
OG0006082	0	0	1	0	0	1	2
OG0006083	0	0	1	0	0	1	2
OG0006084	0	0	1	0	0	1	2
OG0006085	0	0	1	0	1	0	2
OG0006086	0	0	1	0	0	1	2
OG0006087	0	0	1	0	0	1	2
OG0006088	0	0	1	0	0	1	2
OG0006089	0	0	1	0	0	1	2
OG0006090	0	0	1	1	0	0	2
OG0006091	0	0	1	0	1	0	2
OG0006092	0	0	1	0	0	1	2
OG0006093	0	0	1	0	0	1	2
OG0006094	0	0	1	0	0	1	2
OG0006095	0	0	1	0	0	1	2
OG0006096	0	0	1	0	0	1	2
OG0006097	0	0	1	0	0	1	2
OG0006098	0	0	1	0	0	1	2
OG0006099	0	0	1	0	0	1	2
OG0006100	0	0	1	0	0	1	2
OG0006101	0	0	1	0	0	1	2
OG0006102	0	0	1	0	0	1	2
OG0006103	0	0	1	0	0	1	2
OG0006104	0	0	1	0	0	1	2
OG0006105	0	0	2	0	0	0	2
OG0006106	0	0	1	0	0	1	2
OG0006107	0	0	1	0	1	0	2
OG0006108	0	0	1	0	0	1	2
OG0006109	0	0	1	0	1	0	2
OG0006110	0	0	1	0	0	1	2
OG0006111	0	0	2	0	0	0	2
OG0006112	0	0	1	0	0	1	2
OG0006113	0	0	1	0	0	1	2
OG0006114	0	0	1	0	1	0	2
OG0006115	0	0	1	0	0	1	2
OG0006116	0	0	1	0	1	0	2
OG0006117	0	0	2	0	0	0	2
OG0006118	0	0	1	0	0	1	2
OG0006119	0	0	1	0	0	1	2
OG0006120	0	0	1	0	0	1	2
OG0006121	0	0	1	0	0	1	2
OG0006122	0	0	1	0	0	1	2
OG0006123	0	0	2	0	0	0	2
OG0006124	0	0	1	0	1	0	2
OG0006125	0	0	1	0	1	0	2
OG0006126	0	0	1	0	1	0	2
OG0006127	0	0	1	0	1	0	2
OG0006128	0	0	1	0	0	1	2
OG0006129	0	0	1	0	0	1	2
OG0006130	0	0	1	0	0	1	2
OG0006131	0	0	1	0	0	1	2
OG0006132	0	0	1	0	0	1	2
OG0006133	0	0	1	1	0	0	2
OG0006134	0	0	1	0	0	1	2
OG0006135	0	0	1	0	0	1	2
OG0006136	0	0	1	0	0	1	2
OG0006137	0	0	1	0	1	0	2
OG0006138	0	0	1	0	0	1	2
OG0006139	0	0	1	0	0	1	2
OG0006140	0	0	1	0	0	1	2
OG0006141	0	0	1	0	0	1	2
OG0006142	0	0	1	0	0	1	2
OG0006143	0	0	1	0	0	1	2
OG0006144	0	0	1	0	0	1	2
OG0006145	0	0	1	0	0	1	2
OG0006146	0	0	1	0	0	1	2
OG0006147	0	0	1	0	0	1	2
OG0006148	0	0	1	0	0	1	2
OG0006149	0	0	1	0	0	1	2
OG0006150	0	0	1	0	0	1	2
OG0006151	0	0	1	0	0	1	2
OG0006152	0	0	1	0	1	0	2
OG0006153	0	0	2	0	0	0	2
OG0006154	0	0	1	0	0	1	2
OG0006155	0	0	1	0	0	1	2
OG0006156	0	0	1	0	0	1	2
OG0006157	0	0	1	0	0	1	2
OG0006158	0	0	1	0	0	1	2
OG0006159	0	0	1	0	1	0	2
OG0006160	0	0	1	0	1	0	2
OG0006161	0	0	1	0	1	0	2
OG0006162	0	0	1	0	0	1	2
OG0006163	0	0	1	0	0	1	2
OG0006164	0	0	1	0	1	0	2
OG0006165	0	0	1	0	0	1	2
OG0006166	0	0	1	0	0	1	2
OG0006167	0	0	1	0	0	1	2
OG0006168	0	0	1	0	0	1	2
OG0006169	0	0	1	0	0	1	2
OG0006170	0	0	1	0	0	1	2
OG0006171	0	0	1	0	0	1	2
OG0006172	0	0	1	0	0	1	2
OG0006173	0	0	1	0	0	1	2
OG0006174	0	0	1	0	0	1	2
OG0006175	0	0	1	0	0	1	2
OG0006176	0	0	1	0	0	1	2
OG0006177	0	0	1	0	0	1	2
OG0006178	0	0	1	0	0	1	2
OG0006179	0	0	1	0	0	1	2
OG0006180	0	0	1	0	0	1	2
OG0006181	0	0	1	0	0	1	2
OG0006182	0	0	1	0	1	0	2
OG0006183	0	0	1	0	0	1	2
OG0006184	0	0	1	0	0	1	2
OG0006185	0	0	1	0	0	1	2
OG0006186	0	0	1	0	1	0	2
OG0006187	0	0	1	0	0	1	2
OG0006188	0	0	1	0	0	1	2
OG0006189	0	0	1	0	0	1	2
OG0006190	0	0	1	0	0	1	2
OG0006191	0	0	1	0	0	1	2
OG0006192	0	0	1	0	0	1	2
OG0006193	0	0	1	0	0	1	2
OG0006194	0	0	1	0	0	1	2
OG0006195	0	0	1	0	0	1	2
OG0006196	0	0	1	0	0	1	2
OG0006197	0	0	1	0	0	1	2
OG0006198	0	0	1	0	0	1	2
OG0006199	0	0	1	0	0	1	2
OG0006200	0	0	1	0	0	1	2
OG0006201	0	0	1	0	0	1	2
OG0006202	0	0	1	0	0	1	2
OG0006203	0	0	1	0	0	1	2
OG0006204	0	0	2	0	0	0	2
OG0006205	0	0	1	0	0	1	2
OG0006206	0	0	1	0	0	1	2
OG0006207	0	0	1	0	0	1	2
OG0006208	0	0	1	0	0	1	2
OG0006209	0	0	1	0	0	1	2
OG0006210	0	0	1	0	1	0	2
OG0006211	0	0	1	0	0	1	2
OG0006212	0	0	1	0	0	1	2
OG0006213	0	0	1	0	1	0	2
OG0006214	0	0	1	0	0	1	2
OG0006215	0	0	1	0	0	1	2
OG0006216	0	0	1	0	0	1	2
OG0006217	0	0	1	0	0	1	2
OG0006218	0	0	1	0	0	1	2
OG0006219	0	0	1	0	0	1	2
OG0006220	0	0	1	0	1	0	2
OG0006221	0	0	1	0	1	0	2
OG0006222	0	0	1	0	1	0	2
OG0006223	0	0	1	0	0	1	2
OG0006224	0	0	1	0	0	1	2
OG0006225	0	0	1	0	0	1	2
OG0006226	0	0	1	0	0	1	2
OG0006227	0	0	1	0	0	1	2
OG0006228	0	0	1	0	0	1	2
OG0006229	0	0	1	0	0	1	2
OG0006230	0	0	1	0	0	1	2
OG0006231	0	0	1	0	0	1	2
OG0006232	0	0	1	0	0	1	2
OG0006233	0	0	1	0	1	0	2
OG0006234	0	0	2	0	0	0	2
OG0006235	0	0	1	0	0	1	2
OG0006236	0	0	1	0	0	1	2
OG0006237	0	0	1	0	0	1	2
OG0006238	0	0	1	0	0	1	2
OG0006239	0	0	1	0	1	0	2
OG0006240	0	0	1	0	0	1	2
OG0006241	0	0	1	0	0	1	2
OG0006242	0	0	1	0	0	1	2
OG0006243	0	0	1	0	0	1	2
OG0006244	0	0	1	0	0	1	2
OG0006245	0	0	1	0	0	1	2
OG0006246	0	0	1	0	0	1	2
OG0006247	0	0	1	0	0	1	2
OG0006248	0	0	2	0	0	0	2
OG0006249	0	0	1	0	0	1	2
OG0006250	0	0	1	0	1	0	2
OG0006251	0	0	1	0	0	1	2
OG0006252	0	0	1	0	0	1	2
OG0006253	0	0	1	0	0	1	2
OG0006254	0	0	1	0	0	1	2
OG0006255	0	0	1	0	0	1	2
OG0006256	0	0	2	0	0	0	2
OG0006257	0	0	1	0	0	1	2
OG0006258	0	0	1	0	0	1	2
OG0006259	0	0	0	2	0	0	2
OG0006260	0	0	0	2	0	0	2
OG0006261	0	0	0	2	0	0	2
OG0006262	0	0	0	2	0	0	2
OG0006263	0	0	0	2	0	0	2
OG0006264	0	0	0	2	0	0	2
OG0006265	0	0	0	2	0	0	2
OG0006266	0	0	0	2	0	0	2
OG0006267	0	0	0	2	0	0	2
OG0006268	0	0	0	2	0	0	2
OG0006269	0	0	0	2	0	0	2
OG0006270	0	0	0	2	0	0	2
OG0006271	0	0	0	2	0	0	2
OG0006272	0	0	0	2	0	0	2
OG0006273	0	0	0	2	0	0	2
OG0006274	0	0	0	2	0	0	2
OG0006275	0	0	0	2	0	0	2
OG0006276	0	0	0	2	0	0	2
OG0006277	0	0	0	2	0	0	2
OG0006278	0	0	0	2	0	0	2
OG0006279	0	0	0	2	0	0	2
OG0006280	0	0	0	2	0	0	2
OG0006281	0	0	0	2	0	0	2
OG0006282	0	0	0	2	0	0	2
OG0006283	0	0	0	2	0	0	2
OG0006284	0	0	0	2	0	0	2
OG0006285	0	0	0	2	0	0	2
OG0006286	0	0	0	2	0	0	2
OG0006287	0	0	0	2	0	0	2
OG0006288	0	0	0	2	0	0	2
OG0006289	0	0	0	2	0	0	2
OG0006290	0	0	0	2	0	0	2
OG0006291	0	0	0	2	0	0	2
OG0006292	0	0	0	2	0	0	2
OG0006293	0	0	0	2	0	0	2
OG0006294	0	0	0	2	0	0	2
OG0006295	0	0	0	2	0	0	2
OG0006296	0	0	0	2	0	0	2
OG0006297	0	0	0	2	0	0	2
OG0006298	0	0	0	2	0	0	2
OG0006299	0	0	0	2	0	0	2
OG0006300	0	0	0	2	0	0	2
OG0006301	0	0	0	2	0	0	2
OG0006302	0	0	0	2	0	0	2
OG0006303	0	0	0	2	0	0	2
OG0006304	0	0	0	2	0	0	2
OG0006305	0	0	0	2	0	0	2
OG0006306	0	0	0	2	0	0	2
OG0006307	0	0	0	2	0	0	2
OG0006308	0	0	0	2	0	0	2
OG0006309	0	0	0	2	0	0	2
OG0006310	0	0	0	2	0	0	2
OG0006311	0	0	0	2	0	0	2
OG0006312	0	0	0	2	0	0	2
OG0006313	0	0	0	2	0	0	2
OG0006314	0	0	0	2	0	0	2
OG0006315	0	0	0	2	0	0	2
OG0006316	0	0	0	2	0	0	2
OG0006317	0	0	0	1	1	0	2
OG0006318	0	0	0	2	0	0	2
OG0006319	0	0	0	2	0	0	2
OG0006320	0	0	0	2	0	0	2
OG0006321	0	0	0	2	0	0	2
OG0006322	0	0	0	2	0	0	2
OG0006323	0	0	0	2	0	0	2
OG0006324	0	0	0	2	0	0	2
OG0006325	0	0	0	1	1	0	2
OG0006326	0	0	0	2	0	0	2
OG0006327	0	0	0	0	1	1	2
OG0006328	0	0	0	0	2	0	2
OG0006329	0	0	0	0	1	1	2
OG0006330	0	0	0	0	2	0	2
OG0006331	0	0	0	0	1	1	2
OG0006332	0	0	0	0	1	1	2
OG0006333	0	0	0	0	1	1	2
OG0006334	0	0	0	0	1	1	2
OG0006335	0	0	0	0	1	1	2
OG0006336	0	0	0	0	1	1	2
OG0006337	0	0	0	0	1	1	2
OG0006338	0	0	0	0	1	1	2
OG0006339	0	0	0	0	1	1	2
OG0006340	0	0	0	0	1	1	2
OG0006341	0	0	0	0	1	1	2
OG0006342	0	0	0	0	1	1	2
OG0006343	0	0	0	0	1	1	2
OG0006344	0	0	0	0	1	1	2
OG0006345	0	0	0	0	1	1	2
OG0006346	0	0	0	0	1	1	2
OG0006347	0	0	0	0	1	1	2
OG0006348	0	0	0	0	1	1	2
OG0006349	0	0	0	0	1	1	2
OG0006350	0	0	0	0	1	1	2
OG0006351	0	0	0	0	1	1	2
OG0006352	0	0	0	0	1	1	2
OG0006353	0	0	0	0	1	1	2
OG0006354	0	0	0	0	1	1	2
OG0006355	0	0	0	0	1	1	2
OG0006356	0	0	0	0	1	1	2
OG0006357	0	0	0	0	1	1	2
OG0006358	0	0	0	0	1	1	2
OG0006359	0	0	0	0	1	1	2
OG0006360	0	0	0	0	1	1	2
OG0006361	0	0	0	0	1	1	2
OG0006362	0	0	0	0	1	1	2
OG0006363	0	0	0	0	1	1	2
OG0006364	0	0	0	0	2	0	2
OG0006365	0	0	0	0	2	0	2
OG0006366	0	0	0	0	1	1	2
OG0006367	0	0	0	0	1	1	2
OG0006368	0	0	0	0	1	1	2
OG0006369	0	0	0	0	1	1	2
OG0006370	0	0	0	0	1	1	2
OG0006371	0	0	0	0	1	1	2
OG0006372	0	0	0	0	1	1	2
OG0006373	0	0	0	0	1	1	2
OG0006374	0	0	0	0	1	1	2
OG0006375	0	0	0	0	1	1	2
OG0006376	0	0	0	0	1	1	2
OG0006377	0	0	0	0	1	1	2
OG0006378	0	0	0	0	2	0	2
OG0006379	0	0	0	0	1	1	2
OG0006380	0	0	0	0	1	1	2
OG0006381	0	0	0	0	1	1	2
OG0006382	0	0	0	0	1	1	2
OG0006383	0	0	0	0	1	1	2
OG0006384	0	0	0	0	1	1	2
OG0006385	0	0	0	0	1	1	2
OG0006386	0	0	0	0	1	1	2
OG0006387	0	0	0	0	1	1	2
OG0006388	0	0	0	0	1	1	2
OG0006389	0	0	0	0	1	1	2
OG0006390	0	0	0	0	1	1	2
OG0006391	0	0	0	0	1	1	2
OG0006392	0	0	0	0	1	1	2
OG0006393	0	0	0	0	1	1	2
OG0006394	0	0	0	0	1	1	2
OG0006395	0	0	0	0	1	1	2
OG0006396	0	0	0	0	1	1	2
OG0006397	0	0	0	0	1	1	2
OG0006398	0	0	0	0	1	1	2
OG0006399	0	0	0	0	1	1	2
OG0006400	0	0	0	0	1	1	2
OG0006401	0	0	0	0	1	1	2
OG0006402	0	0	0	0	1	1	2
OG0006403	0	0	0	0	1	1	2
OG0006404	0	0	0	0	1	1	2
OG0006405	0	0	0	0	1	1	2
OG0006406	0	0	0	0	1	1	2
OG0006407	0	0	0	0	1	1	2
OG0006408	0	0	0	0	1	1	2
OG0006409	0	0	0	0	1	1	2
OG0006410	0	0	0	0	1	1	2
OG0006411	0	0	0	0	1	1	2
OG0006412	0	0	0	0	1	1	2
OG0006413	0	0	0	0	1	1	2
OG0006414	0	0	0	0	1	1	2
OG0006415	0	0	0	0	1	1	2
OG0006416	0	0	0	0	1	1	2
OG0006417	0	0	0	0	0	2	2
OG0006418	0	0	0	0	0	2	2
OG0006419	0	0	0	0	0	2	2
OG0006420	0	0	0	0	0	2	2
OG0006421	0	0	0	0	0	2	2
